border_size=1
usage=map

Mm^Xm       , Mm^Xm       , Mm^Xm       , Mm^Xm       , Mm^Xm       , Mm^Xm       , Mm          , Mm          , Hh          , Hh          , Ww          , Hh^Fds      , Mm^Xm       , Xu          , Wo^Ii       , Xu          , Xu          , Xu          , Xu          , Xu          , Xu          , Xu          , Xu          , Xu          , Xu          , Xu          , Xu          , Xu          , Xu          , Xu          , Xu          , Xu          , Xu          , Xu          , Xu          , Xu          , Mm^Xm       , Mm^Xm       , Rr          , Rp          , Rr          , Rr          
Mm^Xm       , Mm^Xm       , 6 Kv        , Cv          , Cv          , Mm          , Hh          , Hh          , Ww          , Ww          , Ww          , Hh^Fp       , Hh^Fp       , Mm^Xm       , Uu^Ii       , Ww^Ii       , Ur          , Uh          , Ur          , Ur          , Ur          , Ur          , Ur          , Uh          , Uu          , Xu          , Uu^Ufi      , Uu          , Ur          , Ur          , Ur          , Uh          , Ur          , Uu          , Xu          , Mm^Xm       , Rr          , Rr          , 1 Kh        , 3 Kh        , 5 Kh        , Rr          
Mm^Xm       , Cv          , Cv          , Cv          , Cv          , Rd          , Rd          , Hh^Fp       , Ww          , Gg^Fet      , Ww          , Gs^Fp       , Hh          , Mm^Xm       , Mm^Xm       , Xu          , Xu          , Ur          , Ur          , Uh          , Xu          , Xu          , Ur          , Xu          , Xu          , Xu          , Xu          , Ur          , Xu          , Xu          , Xu          , Ur          , Ur^Ii       , Uh^Ii       , Xu          , Mm^Xm       , Rr          , Rr          , Rr          , Rr          , 4 Kh        , Rr          
Mm^Xm       , Cv          , Cv          , Cv          , Gs^Fms      , Rd          , Wwf         , Wwf         , Wwf         , Ww          , Gs^Fp       , Gs^Fp       , Hh^Fp       , Hh^Fp       , Hh^Fp       , Mm^Xm       , Xu          , Xu          , Xu          , Ur          , Xu          , Uu          , Uh          , Ur          , Ur          , Uu          , Ur          , Ur          , Xu          , Uh          , Uu          , Ur          , Xu          , Ur^Ii       , Mm^Xm       , Mm^Xm       , Mm          , Rr          , Rr          , 2 Kh        , Rr          , Rr          
Mm^Xm       , Mm^Xm       , Mm          , Hh^Fp       , Hh^Fp       , Gs^Fp       , Ww          , Wwf         , Rd          , Rd          , Gs^Fms      , Gs^Fms      , Gs^Fp       , Hh          , Hh^Fp       , Mm^Xm       , Xu          , Ur          , Xu          , Ur          , Uu^Ufi      , Xu          , Xu          , Uu^Ufi      , Xu          , Ur          , Uh          , Uh          , Xu          , Uu^Ufi      , Xu          , Uh          , Xu          , Mm^Xm       , Rr          , Mm          , Rr          , Rr          , Rr          , Rr          , Mm          , Hh          
Ms          , Mm^Xm       , Mm          , Hh          , Ww          , Ww          , Ww          , Gs^Fds      , Rd          , Rd          , Rd          , Gs^Fp       , Gs^Fp       , Gs^Fp       , Hh^Fp       , Mm^Xm       , Xu          , Uu^Ii       , Ur^Ii       , Ur^Ii       , Xu          , Xu          , Mm^Xm       , Xu          , Mm^Xm       , Xu          , Xu          , Xu          , Mm^Xm       , Xu          , Mm^Xm       , Xu          , Mm^Xm       , Mm^Xm       , Rr          , Hh          , Rr          , Rr          , Mm          , Mm          , Xu          , Mm          
Ms          , Mm^Xm       , Mm          , Hh          , Ww          , Gg^Fet      , Ww          , Gs^Fp       , Gs^Fms      , Rd          , Rd          , Gs^Fms      , Gs^Fp       , Gs^Fms      , Hh          , Mm^Xm       , Mm^Xm       , Xu          , Mm^Xm       , Xu          , Mm          , Mm          , Hh          , Hh          , Mm          , Xu          , Mm^Xm       , Mm^Xm       , Mm          , Mm^Xm       , Mm          , Mm          , Rr          , Rr          , Hh          , Rr          , Hh          , Mm          , Xu          , Xu          , Uh          , Xu          
Ms          , Mm^Xm       , Mm^Xm       , Hh          , Wo          , Ww          , Hh^Fp       , Hh^Fp       , Gs^Fms      , Rd          , Rd          , Rd          , Gs^Fp       , Gs^Fp       , Hh^Fp       , Mm^Xm       , Mm^Xm       , Mm          , Rr          , Mm          , Rr          , Rr          , Rr          , Rr          , Rr          , Mm          , Mm          , Mm          , Mm          , Mm          , Hh          , Hh          , Rr          , Rr          , Hh          , Hh          , Mm          , Mm          , Xu          , Uu^Ufi      , Ur          , Xu          
Mm^Xm       , Ms          , Mm^Xm       , Mm^Xm       , Wo          , Hh          , Hh          , Hh^Fp       , Hh^Fp       , Gs^Fms      , Rd          , Rd          , Rd          , Gs^Fp       , Cv          , Mm^Xm       , Rr          , Rr          , Rr          , Rr          , Hh          , Rr          , Hh          , Rr          , Rr          , Hh          , Mm          , Mm          , Mm          , Hh          , Hh          , Hh^Fp       , Rr          , Hh          , Hh          , Mm          , Xu          , Xu          , Qxu         , Ur          , Qxu         , Xu          
Mm          , Mm^Xm       , Hh^Fp       , Mm^Xm       , Wo          , Mm^Xm       , Mm^Xm       , Hh          , Mm^Xm       , Hh^Fp       , Hh^Fp       , Rd          , Rd          , Rd          , Rp          , Rp          , Rp          , Rr          , Gs^Fds      , Gs^Fds      , Gs^Fds      , Hh          , Hh^Fp       , Hh^Fms      , Rr          , Rr          , Rr          , Ch          , Hh^Fms      , Hh          , Hh^Fp       , Rr          , Rr          , Hh^Fms      , Hh          , Mm          , Xu          , Uh          , Uu^Ufi      , Ur^Ii       , Uh          , Xu          
Mm          , Mm          , Hh^Fds      , Ww          , Wo          , Ww          , Hh^Fp       , Mm^Xm       , Mm^Xm       , Hh          , Mm^Xm       , Cv          , Rr          , Rr          , Rp          , Rp          , Gs^Fp       , Gs^Fds      , Gs^Fms      , Gs^Fp       , Gs^Fmw      , Gs^Fmw      , Gs^Fms      , Hh          , Hh^Fms      , Rr          , Rr          , Rr          , Rr          , Rr          , Rr          , Rr          , Hh^Fp       , Rp          , Rp          , Mm          , Xu          , Xu          , Xu          , Ur          , Ur          , Xu          
Mm          , Mm          , Hh          , Ww          , Wo          , Ww          , Hh^Fds      , Mm          , Hh^Fms      , Mm^Xm       , Rr          , Rr          , Rr          , Rr          , Hh^Fp       , Ggf         , Gs^Fp       , Gs^Fp       , Gs^Fds      , Gs^Fp       , Hh^Fp       , Gs^Fmw      , Hh^Fms      , Hh          , Hh          , Ch          , Hh^Fms      , Rr          , Hh^Fms      , Rr          , Hh          , Rr          , Hh          , Hh          , Mm          , Ur^Ii       , Ur^Ii       , Uh^Ii       , Qxu         , Ur          , Uh          , Xu          
Mm          , Hh^Fp       , Hh          , Ww          , Ww          , Wo          , Ww          , Hh          , Rr          , Rr          , Rr          , Rr          , Mm^Xm       , Cv          , Hh          , Gs^Fp       , Hh^Fp       , Gs^Fms      , Hh          , Hh^Fds      , Hh          , Hh^Fp       , Mm^Xm       , Mm          , Mm          , Hh          , Mm          , Hh          , Mm          , Hh          , Mm          , Hh          , Mm          , Mm          , Mm^Xm       , Xu          , Xu          , Ur^Ii       , Ur          , Ur          , Uu^Ufi      , Xu          
Mm          , Hh          , Hh^Fds      , Ww          , Ww          , Wo          , Ww          , Ww          , Wwf         , Rr          , Gg          , Mm^Xm       , Mm^Xm       , Mm          , Mm          , Hh          , Hh^Fds      , Hh^Fp       , Hh          , Hh          , Mm^Xm       , Mm^Xm       , Xu          , Xu          , Xu          , Mm          , Mm^Xm       , Mm          , Mm^Xm       , Mm^Xm       , Mm^Xm       , Mm          , Mm^Xm       , Mm^Xm       , Xu          , Xu          , Cud         , Xu          , Xu          , Uh          , Xu          , Xu          
Hh          , Hh          , Gs^Fds      , Gs^Fds      , Chs         , Ww          , Wwf         , Wwf         , Wwf         , Wwf         , Ww          , Hh          , Mm          , Mm^Xm       , Mm          , Hh          , Hh          , Hh          , Mm          , Mm          , Mm^Xm       , Xu          , Xu          , Cud         , Ur          , Xu          , Xu          , Mm^Xm       , Xu          , Xu          , Xu          , Xu          , Xu          , Xu          , Cud         , Ql          , Cud         , Cud         , Xu          , Xu          , Xu          , Xu          
Hh          , Hh          , Hh^Fds      , Ss          , Ss          , Rp          , Rp          , Wwf         , Ww          , Ww          , Ww          , Hh          , Hh          , Mm^Xm       , Mm^Xm       , Mm          , Mm          , Mm          , Mm^Xm       , Mm^Xm       , Xu          , Xu          , Cud         , Xu          , Ur          , Uu          , Uh^Ii       , Uu^Ufi      , Uu^Ufi      , Uh          , Ur          , Cud         , Uh          , Ur          , Xu          , Cud         , Ql          , Cud         , Xu          , Uu^Ufi      , Uh          , Xu          
Hh          , Hh          , Gs^Fds      , Ss          , Gg          , Rp          , Rp          , Chw         , Gs^Fp       , Ww          , Wo          , Ww          , Gs^Fp       , Hh          , Mm          , Mm^Xm       , Mm^Xm       , Mm^Xm       , Xu          , Xu          , Kud         , Xu          , Xu          , Ur          , Uh          , Ur          , Ur          , Uh^Ii       , Ur          , Ur          , Uh          , Ur          , Ur          , Ur          , Ur          , Cud         , Xu          , Xu          , Uh          , Ur          , Uh          , Xu          
Hh          , Hh^Fms      , Hh^Fds      , Gg          , Gs^Fp       , Rp          , Re          , Ss          , Gs^Fp       , Ww          , Wo          , Ww          , Ww          , Gs^Fp       , Hh          , Mm          , Mm^Xm       , Xu          , 9 Kud       , Cud         , Cud         , Cud         , Cud         , Xu          , Xu          , Uu^Ufi      , Uh          , Ur          , Xu          , Cud         , Xu          , Xu          , Xu          , Uu          , Xu          , Xu          , Ql          , Uu          , Ur          , Ur          , Ql          , Xu          
Hh          , Hh          , Gg          , Gg          , Ss          , Re          , Re          , Gg          , Gg          , Ss          , Ss          , Wo          , Wo          , Hh          , Hh          , Mm          , Mm^Xm       , Xu          , Cud         , Cud         , Ql          , Cud         , Xu          , Ur          , Ur          , Xu          , Xu          , Ur          , Xu          , Xu          , Ur          , Cud         , Ur          , Xu          , Xu          , Xu          , Ur          , Ur          , Ur          , Ql          , Ql          , Qlf         
Hh          , Hh          , Gg          , Ss          , Gs^Fp       , Rp          , Rp          , Re          , Ss          , Re          , Re          , Ww          , Wo          , Gg          , Gs^Fp       , Mm^Xm       , Mm^Xm       , Xu          , Kud         , Cud         , Cud         , Cud         , Ur          , Ur          , Ur          , Ql          , Ur          , Cud         , Ur          , Ur          , Ur          , Ur          , Ur          , Ur          , Ur          , Cud         , Xu          , Xu          , Uh          , Uu^Ufi      , Ur^Ii       , Qlf         
Hh          , Hh^Fms      , Gg          , Ss          , Ss          , Rp          , Re          , Gs^Fp       , Ww          , Ss          , Wo          , Ww          , Wo          , Ww          , Hh          , Mm          , Hh          , Xu          , Xu          , Cud         , Cud         , Xu          , Ur          , Ur          , Xu          , Ur          , Ur          , Ur          , Ur          , Ur          , Xu          , Cud         , Ur          , Ur          , Ur          , Ur          , Ql          , Xu          , Xu          , Ql          , Ur^Ii       , Qlf         
Hh          , Gs^Fds      , Hh^Fms      , Gg          , Ww          , Re          , Wwf         , Ww          , Wo          , Wo          , Ww          , Ww          , Wwf         , Wwf         , Gg          , Hh          , Mm^Xm       , Mm^Xm       , Xu          , Xu          , Xu          , Ur          , Ur          , Ur          , Ur          , Ur          , Ur          , Cud         , Xu          , Xu          , Md          , Xu          , Xu          , Ql          , Ur          , Ur          , Ur          , Cud         , Xu          , Ql          , Ur^Ii       , Qlf         
Gs^Fds      , Gs^Fds      , Ss          , Ww          , Ss          , Wwf         , Re          , Wo          , Ss          , Ww          , Mm^Xm       , Mm          , Mm^Xm       , Gs^Fms      , Mm^Xm       , Mm^Xm       , Xu          , Xu          , Ur          , Uh          , Qxu         , Xu          , Xu          , Ql          , Ur          , Ur          , Xu          , Xu          , Md          , Md          , Rd          , Ch          , Md^Xm       , Xu          , Xu          , Cud         , Ur          , Ur          , Xu          , Cud         , Ql          , Xu          
Gs^Fds      , Ss          , Ww          , Ww          , Chw         , Wwf         , Rp          , Chs         , Hh          , Mm          , Mm^Xm       , Mm^Xm       , Xu          , Mm^Xm       , Xu          , Xu          , Uh          , Ur          , Qxu         , Qxu^Bs\     , Ur          , Cud         , Xu          , Xu          , Cud         , Xu          , Ch          , Md          , Hd          , Rd          , Md^Xm       , Rd          , Rd          , Hd          , Xu          , Qxu         , Ur          , Ur          , Xu          , Xu          , Xu          , Xu          
Wo          , Wo          , Ww          , Gg          , Ss          , Re          , Rp          , Gg          , Hh          , Mm^Xm       , Mm^Xm       , Xu          , Qxu         , Uh^Ii       , Xu          , Xu          , Xu          , Ur          , Cud         , Xu          , Ur          , Uh          , Uu^Ufi      , Qxu         , Ur          , Xu          , Xu          , Md          , Rd          , Rd          , Md^Xm       , Ch          , Rd          , Hd          , Dd          , Xu          , Ur          , Ur          , Cud         , Ur          , Ur          , Xu          
Ww          , Ww          , Gg          , Ggf         , Re          , Rp          , Rp          , Hh          , Mm          , Mm          , Mm^Xm       , Xu          , Uu          , Cud         , Ur          , Uu^Ufi      , Ur          , Ur          , Xu          , Xu          , Xu          , Ur          , Ur          , Ur          , Uh          , Uu^Ufi      , Xu          , Md          , Rd          , Md^Xm       , Md^Xm       , Md          , Hd          , Rd          , Rd          , Xu          , Ur^Ii       , Ur^Ii       , Xu          , Ur          , Ur          , Xu          
Ww          , Ss          , Ggf         , Ss          , Gg          , Rp          , Rp          , Gg          , Hh          , Mm          , Mm^Xm       , Xu          , Xu          , Uh          , Uh          , Ur          , Qxu         , Qxu^Bs\     , Ur          , Qxu         , Uh          , Xu          , Uu          , Uh          , Xu          , Uh^Ii       , Xu          , Md          , Rd          , Dd          , Md          , Md^Xm       , Md^Xm       , Dd          , Md^Xm       , Xu          , Ur^Ii       , Ur^Ii       , Md^Xm       , Ur          , Md^Xm       , Xu          
Ww          , Ss          , Ss          , Gg          , Ss          , Rp          , Rp          , Hh          , Hh          , Mm          , Mm          , Mm^Xm       , Mm^Xm       , Xu          , Xu          , Xu          , Uu          , Uu          , Xu          , Ur          , Uu          , Xu          , Xu          , Xu          , Md^Xm       , Xu          , Md^Xm       , Md^Xm       , Md^Xm       , Md^Xm       , Md^Xm       , Md^Xm       , Md          , Md^Xm       , Md          , Ch          , Rd          , Ur^Ii       , Ch          , Md^Xm       , Md^Xm       , Md^Xm       
Ww          , Ww          , Ww          , Gg          , Ww          , Rp          , Wo^Bw|      , Ss          , Gg          , Mm          , Hh          , Mm          , Mm^Xm       , Xu          , Mm^Xm       , Uh^Ii       , Xu          , Xu          , Xu          , Uu          , Cud^Ii      , Cud^Ii      , Xu          , Md^Xm       , Md          , Md^Xm       , Dd          , Ch          , Dd^Do       , Md          , Md          , Md          , Dd          , Md^Xm       , Md          , Ds          , Dd          , Rd          , Ds          , Md          , Md^Xm       , Md^Xm       
Gg          , Wo          , Wo          , Ww          , Wo          , Wo^Bw|      , Ww^Bw|      , Wo          , Ww          , Hh          , Ss          , Mm          , Mm^Xm       , Mm^Xm       , Mm          , Mm^Xm       , Mm^Xm       , Mm^Xm       , Mm^Xm       , Xu          , Xu          , Xu          , Md^Xm       , Md^Xm       , Hd          , Hd          , Md          , Rd          , Dd          , Md          , Dd^Dc       , Dd          , Dd          , Md^Xm       , Dd          , Ds          , Rd          , Rd          , Dd^Dc       , Dd^Do       , Md          , Md^Xm       
Gg          , Gg          , Ss          , Ww          , Chr         , Ww^Bw|      , Rp          , Wo          , Wo          , Ww          , Chs         , Hh          , Hh          , Mm          , Hh          , Mm          , Mm          , Mm          , Mm          , Mm^Xm       , Mm^Xm       , Md^Xm       , Md          , Md          , Hd          , Hd          , Dd^Dc       , Rd          , Md          , Md          , Dd          , Dd          , Ch          , Dd          , Rd          , Rd          , Dd          , Rd          , Dd          , Dd          , Md          , Md^Xm       
Gg          , Ggf         , Gg          , Gg          , Ss          , Rp          , Wwf         , Ww          , Ww          , Ww          , Rr          , Rp          , Rp          , Gg          , Gg          , Hh          , Hh          , Hh          , Hh          , Mm^Xm       , Mm^Xm       , Md^Xm       , Md^Xm       , Dd          , Dd          , Dd^Do       , Dd^Dc       , Dd          , Dd          , Ds          , Rd          , Rd          , Rd          , Dd^Dc       , Rd          , Rd          , Rd          , Dd^Dc       , Ds          , Dd          , Md^Xm       , Md^Xm       
Gg          , Ss          , Ss          , Gg          , Ss          , Re          , Rp          , Chw         , Wo^Bw/      , Ww^Bw/      , Ww^Bw/      , Wwf         , Rp          , Rp          , Rp          , Hh          , Rd          , Hh          , Gg          , Mm          , Ch          , Mm^Xm       , Rd          , Ds          , Rd          , Dd          , Dd          , Rd          , Rd          , Dd^Dc       , Rd          , Rd          , Dd          , Rd          , Rd          , Dd^Dc       , Rd          , Rd          , Rd          , Dd^Dc       , Dd^Do       , Md^Xm       
Chr         , Ggf         , Chs         , Ggf         , Rp          , Re          , Rp          , Rp          , Rp          , Wo^Bw/      , Wo          , Gg          , Gg          , Rp          , Rp          , Rp          , Rp          , Hh          , Hh          , Hh          , Rd          , Rd          , Rd          , Rd          , Rd          , Rd          , Rd          , Rd          , Dd          , Rd          , Ds          , Ch          , Ds          , Dd          , Dd          , Ds          , Dd          , Rd          , Ch          , Ch          , Ch          , Md^Xm       
Chw         , Chs         , Chw         , Chs         , Chw         , Rp          , Ss          , Rp          , Chs         , Ww          , Wo          , Gg          , Ss          , Ss          , Gg          , Hh          , Gg          , Rd          , Rp          , Rd          , Rd          , Rp          , Md^Xm       , Rd          , Hd          , Rd          , Dd          , Rd          , Dd^Dc       , Dd          , Md^Xm       , Dd^Do       , Dd          , Dd^Dc       , Md          , Dd^Do       , Dd          , Ch          , Chr         , Chr         , Chr         , Ch          
Chr         , Chr         , 7 Khs       , Chs         , Chw         , Chs         , Gg          , Ww          , Ss          , Ww          , Ww          , Ww          , Gg          , Gg          , Ss          , Gg          , Gg          , Hh          , Gg          , Rp          , Hh          , Chr         , Mm^Xm       , Md^Xm       , Md^Xm       , Ds          , Md^Xm       , Ds          , Md          , Md^Xm       , Dd^Dc       , Ds          , Md          , Md^Xm       , Md^Xm       , Md          , Md^Xm       , Ch          , Chr         , Ch          , 8 Khr       , Ch          
Chr         , Chr         , Chw         , Chw         , Chw         , Chs         , Gg          , Gg          , Ss          , Ss          , Ss          , Ww          , Ss          , Ss          , Ss          , Gg          , Gg          , Hh          , Hh          , Hh          , Mm          , Mm          , Mm^Xm       , Mm^Xm       , Md^Xm       , Md^Xm       , Md^Xm       , Md^Xm       , Md^Xm       , Md^Xm       , Md^Xm       , Md^Xm       , Md^Xm       , Md^Xm       , Md^Xm       , Md^Xm       , Md^Xm       , Md^Xm       , Md^Xm       , Ch          , Ch          , Ch          
