border_size=1
usage=map

Xu          , Xu          , Cud         , Xu          , Ql          , Xu          , Cud         , Xu          , Ql          , Xu          , Cud         , Xu          , Xu          , Xu          , Uu^Uf       , Xu          , Uu^Uf       , Xu          , Xu          , Xu          , Qxu         , Qxu         , Cud         , Qxu         , Qxu         , Xu          , Xu          , Xu          , Xu          , Xu          , Rd          , Xu          , Xu          , Xu          , Cud         , Xu          , Xu          , Xu          , Uh          , Xu          , Xu          , Xu          
Xu          , Xu          , Kud         , Xu          , Ql          , Xu          , 9 Kud       , Xu          , Ql          , Xu          , Kud         , Xu          , Xu          , Xu          , Uu^Uf       , Xu          , Uu^Uf       , Xu          , Xu          , Xu          , Qxu         , Qxu         , 7 Kud       , Qxu         , Qxu         , Xu          , Xu          , Xu          , Xu          , Xu          , Rd          , Xu          , Xu          , Xu          , Cud         , Xu          , Xu          , Xu          , Uh          , Xu          , Xu          , Xu          
Cud         , Cud         , Cud         , Cud         , Cud         , Cud         , Cud         , Cud         , Cud         , Cud         , Cud         , Cud         , Xu          , Uu^Uf       , Uh          , Uu          , Uu          , Xu          , Xu          , Cud         , Cud         , Cud         , Cud         , Cud         , Cud         , Cud         , Rd          , Rd          , Rd          , Rd          , Xu          , Rd          , Rd          , Rd          , Rd          , Rd          , Rd          , Xu          , Xu          , Uh          , Xu          , Xu          
Cud         , Cud         , Xu          , Cud         , Xu          , Cud         , Cud         , Cud         , Xu          , Cud         , Xu          , Cud         , Uh          , Xu          , Xu          , Uu          , Uu          , Xu          , Xu          , Xu          , Cud         , Cud         , Cud         , Cud         , Cud         , Cud         , Rd          , Rd          , Rd          , Rd          , Rd          , Rd          , Rd          , Rd          , Xu          , Rd          , Rd          , Rd          , Rd          , Xu          , Xu          , Xu          
Cud         , Cud         , Cud         , Cud         , Xu          , Xu          , Xu          , Xu          , Xu          , Cud         , Cud         , Cud         , Uh          , Uh          , Qxu         , Xu          , Uu          , Xu          , Xu          , Cud         , Ql          , Cud         , Ql          , Cud         , Ql          , Cud         , Xu          , Rd          , Xu          , Xu          , Rd          , Xu          , Xu          , Rd          , Cud         , Xu          , Xu          , Rd          , Rd          , Rd          , Xu          , Xu          
Xu          , Xu          , Xu          , Cud         , Cud         , Cud         , Xu          , Cud         , Cud         , Cud         , Xu          , Xu          , Uh          , Uh          , Qxu         , Xu          , Xu          , Uu          , Xu          , Xu          , Xu          , Xu          , Xu          , Xu          , Xu          , Xu          , Cud         , Xu          , Rr          , Xu          , Cud         , Xu          , Xu          , Xu          , Rr          , Xu          , Xu          , Rd          , Rd          , Rd          , Xu          , Xu          
Xu          , Xu          , Xu          , Cud         , Xu          , Rd          , Rd          , Rd          , Xu          , Cud         , Xu          , Xu          , Qxu         , Xu          , Uh          , Qxu         , Xu          , Uh          , Mm          , Mm          , Mm          , Mm          , Mm          , Xu          , Mm          , Xu          , Xu          , Rr          , Ql          , Rr          , Xu          , Xu          , Cud         , Rr          , Xu          , Xu          , Cud         , Uu          , Xu          , Rd          , Xu          , Xu          
Xu          , Xu          , Qxu         , Xu          , Cud         , Rd          , Xu          , Rd          , Cud         , Xu          , Qxu         , Xu          , Xu          , Qxu         , Qxu         , Qxu         , Mm          , Ha          , Ha          , Mm          , Ha          , Aa^Fpa      , Ha          , Mm          , Aa^Fpa      , Mm          , Mm          , Xu          , Xu          , Xu          , Xu          , Xu          , Xu          , Xu          , Aa^Fpa      , Ha          , Re          , Cud         , Xu          , Cud         , Xu          , Xu          
Uh          , Uh          , Uu          , Xu          , Xu          , Rd          , Rd          , Rd          , Xu          , Xu          , Uu          , Uh          , Xu          , Qxu         , Xu          , Xu          , Mm          , Mm          , Ha          , Aa^Fpa      , Ha          , Ha          , Ha          , Aa^Fpa      , Ha          , Ha          , Aa^Fpa      , Mm          , Mm          , Mm          , Mm          , Mm          , Mm          , Mm          , Aa^Fpa      , Re          , Re          , Ha          , Xu          , Rr          , Rr          , Rr          
Uu          , Uu          , Uu          , Xu          , Rd          , Rd          , Ql          , Rd          , Rd          , Xu          , Uu          , Uu          , Xu          , Qxu         , Qxu         , Xu          , Mm          , Aa^Fpa      , Aa^Fpa      , Aa^Fpa      , Aa^Fpa      , Aa^Fpa      , Re          , Ha          , Aa^Fpa      , Ha          , Re          , Aa^Fpa      , Aa^Fpa      , Ha          , Ha          , Ha          , Aa^Fpa      , Aa^Fpa      , Re          , Re          , Aa^Fpa      , Aa^Fpa      , Xu          , Xu          , Xu          , Xu          
Xu          , Xu          , Xu          , Uu          , Xu          , Rd          , Rd          , Rd          , Xu          , Uu          , Xu          , Xu          , Xu          , Xu          , Mm          , Mm          , Ha          , Aa^Fpa      , Re          , Re          , Re          , Re          , Aa^Fpa      , Re          , Re          , Re          , Aa^Fpa      , Re          , Re          , Re          , Re          , Re          , Re          , Re          , Aa          , Re          , Aa^Fpa      , Mm          , Mm^Xm       , Xu          , Xu          , Xu          
Xu          , Xu          , Xu          , Xu          , Cud         , Rd          , Xu          , Rd          , Cud         , Xu          , Uu^Uf       , Xu          , Xu          , Xu          , Mm          , Mm          , Aa^Fpa      , Aa^Fpa      , Re          , Aa^Fpa      , Aa^Fpa      , Ha          , Ha          , Aa^Fpa      , Aa^Fpa      , Aa^Fpa      , Mm          , Aa^Fpa      , Mm          , Aa^Fpa      , Ha          , Aa^Fpa      , Aa^Fpa      , Aa^Fpa      , Ha          , Re          , Aa^Fpa      , Mm          , Mm          , Mm^Xm       , Xu          , Xu          
Cud         , Cud         , Rd          , Xu          , Xu          , Rd          , Rd          , Rd          , Xu          , Xu          , Uu          , Xu          , Xu          , Mm          , Mm          , Aa^Fpa      , Aa^Fpa      , Re          , Aa^Fpa      , Ha          , Ha          , Ha          , Mm          , Ha          , Ha          , Mm          , Xu          , Mm          , Mm          , Mm          , Mm          , Mm          , Mm          , Aa^Fpa      , Ha          , Re          , Re          , Aa^Fpa      , Mm          , Mm          , Xu          , Xu          
Xu          , Xu          , Xu          , Xu          , Uu          , Rd          , Rd          , Rd          , Xu          , Uu          , Xu          , Uu^Uf       , Xu          , Mm^Xm       , Mm          , Ha          , Aa^Fpa      , Re          , Aa^Fpa      , Ha          , Mm^Xm       , Mm          , Xu          , Xu          , Uh          , Xu          , Uh          , Xu          , Xu          , Mm          , Xu          , Xu          , Mm          , Aa^Fpa      , Aa^Fpa      , Ha          , Re          , Aa^Fpa      , Aa^Fpa      , Mm          , Xu          , Xu          
Xu          , Xu          , Rr          , Rr          , Rr          , Uu          , Xu          , Xu          , Xu          , Uu          , Uu          , Xu          , Xu          , Mm^Xm       , Mm          , Mm          , Ha          , Re          , Aa^Fpa      , Mm          , Xu          , Qxu         , Qxu         , Xu          , Xu          , Xu          , Uh          , Xu          , Uh          , Qxu         , Qxu         , Xu          , Xu          , Mm          , Mm          , Aa^Fpa      , Ha          , Re          , Aa^Fpa      , Mm          , Mm          , Mm          
Xu          , Xu          , Rr          , Rr          , Rr          , Xu          , Xu          , Xu          , Ql          , Xu          , Xu          , Uh          , Uh          , Xu          , Mm          , Mm          , Ha          , Re          , Aa^Fpa      , Mm          , Xu          , Xu          , Qxu         , Xu          , Uh          , Uh          , Xu          , Uh          , Xu          , Xu          , Xu          , Qxu         , Qxu         , Mm^Xm       , Mm^Xm       , Aa^Fpa      , Ha          , Re          , Re          , Aa^Fpa      , Aa^Fpa      , Aa^Fpa      
Xu          , Xu          , Rr          , Xu          , Rr          , Xu          , Ql          , Ql          , Xu          , Ql          , Ql          , Xu          , Xu          , Uh          , Mm          , Mm          , Aa^Fpa      , Re          , Aa^Fpa      , Mm          , Mm          , Xu          , Xu          , Qxu         , Xu          , Xu          , Cud         , Cud         , Xu          , Uh          , Mm^Xm       , Xu          , Xu          , Qxu         , Mm          , Aa^Fpa      , Ha          , Aa          , Re          , Ha          , Ha          , Ha          
Xu          , Xu          , Rr          , Rr          , Rr          , Xu          , Ql          , Xu          , 8 Kud       , Xu          , Ql          , Ql          , Xu          , Mm          , Mm          , Mm          , Aa^Fpa      , Re          , Aa          , Ha          , Mm          , Mm^Xm       , Xu          , Xu          , Xu          , Cud         , 6 Kud       , Cud         , Xu          , Mm          , Wo          , Mm^Xm       , Xu          , Xu          , Mm^Xm       , Mm          , Aa^Fpa      , Ha          , Re          , Aa^Fpa      , Aa^Fpa      , Aa^Fpa      
Xu          , Xu          , Rr          , Ql          , Rr          , Xu          , Cud         , Cud         , Cud         , Cud         , Cud         , Xu          , Xu          , Mm          , Aa^Fpa      , Aa^Fpa      , Aa^Fpa      , Re          , Aa^Fpa      , Aa^Fpa      , Mm          , Mm          , Qxu         , Xu          , Cud         , Cud         , Cud         , Cud         , Xu          , Mm^Xm       , Wo          , Mm^Xm       , Mm^Xm       , Xu          , Mm^Xm       , Mm          , Aa^Fpa      , Ha          , Re          , Aa^Fpa      , Ha          , Ha          
Xu          , Xu          , Rr          , Rr          , Rr          , Xu          , Cud         , Cud         , Cud         , Cud         , Cud         , Xu          , Cud         , Mm^Xm       , Ha          , Ha          , Re          , Re          , Aa^Fpa      , Ha          , Mm          , Xu          , Uh          , Xu          , Uu          , Cud         , Xu          , Xu          , Xu          , Mm^Xm       , Mm^Xm       , Wo          , Mm^Xm       , Xu          , Xu          , Mm          , Mm          , Aa^Fpa      , Re          , Ha          , Aa^Fpa      , Aa^Fpa      
Xu          , Xu          , Rr          , Xu          , Rr          , Xu          , Cud         , Cud         , Cud         , Cud         , Cud         , Cud         , Cud         , Re          , Re          , Aa^Fpa      , Re          , Re          , Ha          , Ha          , Mm          , Xu          , Xu          , Uu          , Uu          , Xu          , Uh          , Qxu         , Qxu         , Qxu         , Mm          , Wo          , Mm^Xm       , Xu          , Mm          , Mm          , Aa^Fpa      , Aa^Fpa      , Re          , Aa^Fpa      , Ha          , Ha          
Xu          , Xu          , Xu          , Rr          , Rr          , Xu          , Xu          , Xu          , Ql          , Xu          , Xu          , Xu          , Xu          , Re          , Re          , Re          , Re          , Ha          , Ha          , Mm          , Mm          , Mm^Xm       , Xu          , Uh          , Uu          , Uu          , Xu          , Xu          , Xu          , Xu          , Mm^Xm       , Wo          , Wo          , Mm          , Mm          , Aa^Fpa      , Ha          , Ha          , Chr         , Aa^Fpa      , Aa^Fpa      , Aa^Fpa      
Xu          , Xu          , Xu          , Rr          , Rr          , Rr          , Rr          , Xu          , Ql          , Xu          , Xu          , Xu          , Mm          , Mm          , Aa^Fpa      , Ha          , Re          , Aa^Fpa      , Ha          , Ha          , Mm          , Mm^Xm       , Xu          , Xu          , Xu          , Uh          , Uh          , Uu^Uf       , Uh          , Xu          , Xu          , Mm          , Mm          , Ww          , Wo          , Aa^Fpa      , Ww          , Chr         , Ce          , Chr         , Ha          , Ha          
Xu          , Xu          , Cud         , Xu          , Xu          , Rr          , Rr          , Xu          , Xu          , Xu          , Cud         , Xu          , Mm          , Mm          , Aa^Fpa      , Ha          , Re          , Aa^Fpa      , Ha          , Mm          , Mm^Xm       , Xu          , Uu^Uf       , Xu          , Uu          , Uu          , Xu          , Xu          , Uh          , Uu^Uf       , Uu^Uf       , Xu          , Mm          , Aa^Fpa      , Ha          , Wo          , Wo          , Chr         , Ww^Bw|      , Chr         , Ha          , Ha          
Xu          , Xu          , Xu          , Rd          , Cud         , Rr          , Xu          , Rr          , Cud         , Rd          , Xu          , Xu          , Xu          , Mm          , Mm          , Aa^Fpa      , Re          , Aa^Fpa      , Mm          , Mm          , Xu          , Xu          , Uu^Uf       , Uu          , Uu          , Xu          , Uu^Uf       , Xu          , Uu          , Uu          , Uu          , Xu          , Mm          , Aa^Fpa      , Ha          , Ha          , Aa          , Wo          , Ww^Bw|      , Wo          , Wo          , Wo          
Xu          , Xu          , Cud         , Rd          , Xu          , Rr          , Rr          , Rr          , Xu          , Rd          , Cud         , Xu          , Mm          , Mm          , Aa^Fpa      , Aa^Fpa      , Re          , Ha          , Mm          , Xu          , Xu          , Uu^Uf       , Xu          , Uh          , Uh          , Uu          , Uu          , Uu          , Xu          , Uh          , Uu          , Xu          , Ha          , Ha          , Aa^Fpa      , Ha          , Ha          , Chr         , Kh          , Chr         , Ww          , Ww          
Xu          , Xu          , Xu          , Xu          , Rr          , Rr          , Ql          , Rr          , Rr          , Xu          , Xu          , Xu          , Mm^Xm       , Ha          , Aa^Fpa      , Ha          , Re          , Aa^Fpa      , Aa^Fpa      , Mm          , Mm^Xm       , Xu          , Mm^Xm       , Xu          , Uu^Uf       , Uu^Uf       , Xu          , Xu          , Xu          , Uh          , Uu          , Xu          , Uh          , Mm          , Mm          , Aa^Fpa      , Ha          , Chr         , Chr         , Chr         , Ha          , Ha          
Xu          , Xu          , Rd          , Xu          , Xu          , Rr          , Rr          , Rr          , Xu          , Xu          , Rd          , Xu          , Mm^Xm       , Mm          , Mm          , Aa^Fpa      , Ha          , Re          , Ha          , Mm          , Mm          , Mm          , Mm          , Xu          , Xu          , Xu          , Xu          , Xu          , Uh          , Uh          , Uu          , Uu          , Xu          , Xu          , Mm          , Aa^Fpa      , Aa^Fpa      , Ha          , Re          , Ha          , Aa^Fpa      , Aa^Fpa      
Xu          , Xu          , Xu          , Rd          , Cud         , Rr          , Xu          , Rr          , Cud         , Rd          , Xu          , Xu          , Xu          , Mm          , Ha          , Aa^Fpa      , Aa^Fpa      , Re          , Re          , Aa^Fpa      , Ha          , Aa^Fpa      , Ha          , Mm          , Mm^Xm       , Mm^Xm       , Xu          , Uu^Uf       , Uh          , Uu          , Xu          , Uh          , Uu^Uf       , Xu          , Xu          , Mm          , Aa^Fpa      , Aa          , Re          , Aa^Fpa      , Aa^Fpa      , Aa^Fpa      
Xu          , Xu          , Rd          , Rd          , Xu          , Rr          , Rr          , Rr          , Xu          , Rd          , Rd          , Xu          , Xu          , Mm          , Mm          , Ha          , Ha          , Ha          , Ha          , Re          , Re          , Aa^Fpa      , Ha          , Mm          , Mm          , Mm          , Mm^Xm       , Xu          , Uh          , Xu          , Uu          , Uh          , Xu          , Xu          , Mm^Xm       , Mm          , Aa^Fpa      , Aa          , Re          , Aa^Fpa      , Ha          , Ha          
Xu          , Xu          , Xu          , Xu          , Rr          , Rr          , Rr          , Rr          , Rr          , Xu          , Xu          , Xu          , Qxu         , Xu          , Xu          , Mm          , Mm          , Ha          , Aa^Fpa      , Aa^Fpa      , Ha          , Re          , Re          , Ha          , Aa^Fpa      , Ha          , Mm          , Xu          , Xu          , Uh          , Xu          , Xu          , Uu          , Xu          , Mm          , Mm          , Aa^Fpa      , Aa^Fpa      , Re          , Ha          , Aa^Fpa      , Aa^Fpa      
Xu          , Xu          , Xu          , Ql          , Xu          , Rr          , Rr          , Rr          , Xu          , Ql          , Xu          , Qxu         , Uu          , Qxu         , Xu          , Xu          , Uh          , Ha          , Mm^Xm       , Aa^Fpa      , Ha          , Aa^Fpa      , Aa^Fpa      , Re          , Re          , Aa^Fpa      , Mm          , Mm^Xm       , Xu          , Xu          , Uu          , Uu          , Xu          , Uh          , Ha          , Mm          , Aa^Fpa      , Aa^Fpa      , Re          , Aa^Fpa      , Ha          , Ha          
Xu          , Xu          , Xu          , Xu          , Cud         , Rr          , Rr          , Rr          , Xu          , Xu          , Xu          , Xu          , Xu          , Uu          , Uu          , Xu          , Uh          , Xu          , Xu          , Xu          , Mm^Xm       , Ha          , Ha          , Ha          , Re          , Aa^Fpa      , Mm          , Mm^Xm       , Xu          , Xu          , Uu          , Xu          , Mm^Xm       , Mm          , Mm          , Ha          , Aa^Fpa      , Ha          , Re          , Ha          , Mm          , Mm          
Xu          , Xu          , Rd          , Rd          , Xu          , Xu          , Cud         , Cud         , Ha          , Xu          , Mm          , Mm^Xm       , Mm^Xm       , Xu          , Xu          , Uh          , Uh          , Uu          , Uu          , Xu          , Xu          , Mm^Xm       , Mm          , Aa^Fpa      , Re          , Aa^Fpa      , Mm          , Mm^Xm       , Xu          , Uu          , Uh          , Xu          , Mm          , Mm          , Aa^Fpa      , Aa^Fpa      , Ha          , Aa^Fpa      , Re          , Aa^Fpa      , Mm          , Mm          
Xu          , Xu          , Rd          , Rd          , Xu          , Xu          , Ha          , Re          , Re          , Aa^Fpa      , Aa^Fpa      , Mm          , Mm          , Mm^Xm       , Xu          , Uu^Uf       , Xu          , Xu          , Xu          , Uh          , Ha          , Mm^Xm       , Ha          , Aa^Fpa      , Re          , Ha          , Mm          , Xu          , Xu          , Uu^Uf       , Uh          , Xu          , Mm^Xm       , Mm          , Aa^Fpa      , Ha          , Aa^Fpa      , Aa^Fpa      , Re          , Ha          , Aa^Fpa      , Aa^Fpa      
Xu          , Xu          , Xu          , Xu          , Mm          , Xu          , Aa^Fpa      , Re          , Re          , Re          , Aa^Fpa      , Aa^Fpa      , Aa^Fpa      , Mm          , Mm          , Xu          , Mm^Xm       , Xu          , Mm          , Mm^Xm       , Mm          , Ha          , Aa^Fpa      , Re          , Aa^Fpa      , Ha          , Mm^Xm       , Xu          , Mm^Xm       , Xu          , Xu          , Xu          , Mm          , Mm          , Aa^Fpa      , Aa^Fpa      , Aa^Fpa      , Re          , Ha          , Ha          , Ha          , Ha          
Xu          , Xu          , Mm          , Mm^Xm       , Mm          , Mm          , Aa^Fpa      , Ha          , Re          , Re          , Re          , Aa^Fpa      , Aa^Fpa      , Ha          , Ha          , Mm          , Mm          , Mm          , Ha          , Mm          , Aa^Fpa      , Ha          , Re          , Re          , Ha          , Mm          , Xu          , Xu          , Mm          , Mm          , Mm          , Mm          , Aa^Fpa      , Aa^Fpa      , Aa^Fpa      , Aa^Fpa      , Aa^Fpa      , Re          , Ha          , Ha          , Aa^Fpa      , Aa^Fpa      
Xu          , Xu          , Mm^Xm       , Mm          , Ha          , Aa^Fpa      , Ha          , Aa^Fpa      , Aa^Fpa      , Re          , Re          , Re          , Re          , Aa^Fpa      , Ha          , Ha          , Aa^Fpa      , Aa^Fpa      , Ha          , Ha          , Re          , Re          , Aa^Fpa      , Aa^Fpa      , Mm          , Mm^Xm       , Xu          , Mm^Xm       , Mm          , Aa^Fpa      , Aa^Fpa      , Aa^Fpa      , Aa^Fpa      , Aa^Fpa      , Aa^Fpa      , Aa^Fpa      , Re          , Re          , Ha          , Aa^Fpa      , Mm          , Mm          
Mm          , Mm          , Aa^Fpa      , Aa^Fpa      , Ha          , Aa^Fpa      , Aa^Fpa      , Ha          , Aa          , Aa^Fpa      , Aa          , Re          , Re          , Aa^Fpa      , Re          , Aa^Fpa      , Re          , Aa^Fpa      , Re          , Re          , Aa^Fpa      , Aa^Fpa      , Mm          , Mm          , Xu          , Xu          , Mm          , Mm          , Aa^Fpa      , Ha          , Ha          , Ha          , 3 Kh        , 1 Kh        , Re          , Re          , Aa          , Aa^Fpa      , Ha          , Aa^Fpa      , Mm          , Mm          
Mm          , Mm          , Mm          , Aa^Fpa      , Aa^Fpa      , Aa^Fpa      , Ha          , Ha          , Aa^Fpa      , Aa          , Aa^Fpa      , Re          , Re          , Re          , Re          , Re          , Re          , Re          , Aa^Fpa      , Aa^Fpa      , Mm          , Mm          , Mm^Xm       , Mm^Xm       , Xu          , Mm^Xm       , Mm          , Aa^Fpa      , Aa^Fpa      , Aa^Fpa      , Aa          , Aa          , 5 Kh        , Re          , 2 Kh        , Aa          , Aa^Fpa      , Ha          , Aa^Fpa      , Aa^Fpa      , Mm          , Mm          
Xu          , Xu          , Xu          , Mm          , Mm          , Aa^Fpa      , Aa^Fpa      , Aa          , Aa^Fpa      , Aa          , Aa          , Aa          , Aa^Fpa      , Re          , Re          , Aa^Fpa      , Aa^Fpa      , Aa^Fpa      , Mm^Xm       , Mm          , Mm^Xm       , Mm^Xm       , Xu          , Xu          , Mm          , Mm          , Aa^Fpa      , Aa^Fpa      , Aa^Fpa      , Aa          , Re          , Re          , Aa          , 4 Kh        , Aa          , Aa          , Ha          , Aa^Fpa      , Mm          , Mm          , Xu          , Xu          
Xu          , Xu          , Xu          , Mm          , Mm          , Aa^Fpa      , Aa^Fpa      , Aa          , Aa^Fpa      , Aa          , Aa          , Aa          , Aa^Fpa      , Re          , Re          , Aa^Fpa      , Aa^Fpa      , Aa^Fpa      , Mm^Xm       , Mm          , Mm^Xm       , Mm^Xm       , Xu          , Xu          , Mm          , Mm          , Aa^Fpa      , Aa^Fpa      , Aa^Fpa      , Aa          , Re          , Re          , Aa          , Ch          , Aa          , Aa          , Ha          , Aa^Fpa      , Mm          , Mm          , Xu          , Xu          
