border_size=1
usage=map

Qxu         , Qxu         , Qxu         , Qxu         , Qxu         , Qxu         , Qxu         , Qxu         , Qxu         , Qxu         , Qxu         , Qxu         , Qxu         , Qxu         , Qxu         , Qxu         , Qxu         , Qxu         , Qxu         , Qxu         , Qxu         , Qxu         , Qxu         , Qxu         , Qxu         , Qxu         , Qxu         , Qxu         , Qxu         , Qxu         , Qxu         , Qxu         , Qxu         , Qxu         , Qxu         , Qxu         , Qxu         , Qxu         , Qxu         , Qxu         , Qxu         , Qxu         , Qxu         , Qxu         , Qxu         , Qxu         , Qxu         , Qxu         , Qxu         , Qxu         , Qxu         , Qxu         , Qxu         , Qxu         , Qxu         , Qxu         , Qxu         , Qxu         , Qxu         , Qxu         , Qxu         , Qxu         , Qxu         , Qxu         , Qxu         , Qxu         , Qxu         , Qxu         , Qxu         , Qxu         , Qxu         , Qxu         , Qxu         
Qxu         , Qxu         , Qxu         , Qxu         , Qxu         , Qxu         , Qxu         , Qxu         , Qxu         , Qxu         , Qxu         , Qxu         , Qxu         , Qxu         , Qxu         , Qxu         , Qxu         , Qxu         , Qxu         , Qxu         , Qxu         , Qxu         , Qxu         , Qxu         , Qxu         , Qxu         , Qxu         , Qxu         , Qxu         , Qxu         , Qxu         , Qxu         , Qxu         , Qxu         , Qxu         , Qxu         , Qxu         , Qxu         , Qxu         , Qxu         , Qxu         , Qxu         , Qxu         , Qxu         , Qxu         , Qxu         , Qxu         , Qxu         , Qxu         , Qxu         , Qxu         , Qxu         , Qxu         , Qxu         , Qxu         , Qxu         , Qxu         , Qxu         , Qxu         , Qxu         , Qxu         , Qxu         , Qxu         , Qxu         , Qxu         , Qxu         , Qxu         , Qxu         , Qxu         , Qxu         , Qxu         , Qxu         , Qxu         
Qxu         , Qxu         , Xu          , Xu          , Xu          , Xu          , Xu          , Xu          , Xu          , Xu          , Xu          , Xu          , Xu          , Xu          , Xu          , Xu          , Xu          , Xu          , Xu          , Xu          , Xu          , Xu          , Xu          , Xu          , Xu          , Xu          , Xu          , Xu          , Xu          , Xu          , Xu          , Xu          , Xu          , Xu          , Xu          , Xu          , Xu          , Xu          , Xu          , Xu          , Xu          , Xu          , Xu          , Xu          , Xu          , Xu          , Xu          , Xu          , Xu          , Xu          , Xu          , Xu          , Xu          , Xu          , Xu          , Xu          , Xu          , Xu          , Xu          , Xu          , Xu          , Xu          , Xu          , Xu          , Xu          , Xu          , Xu          , Xu          , Xu          , Xu          , Xu          , Qxu         , Qxu         
Qxu         , Qxu         , Xu          , Xu          , Xu          , Xu          , Xu          , Xu          , Xu          , Xu          , Chw         , Chw         , Chw         , Xu          , Xu          , Xu          , Xu          , Xu          , Xu          , Xu          , Xu          , Xu          , Ss          , Ss          , Ss          , Xu          , Xu          , Xu          , Xu          , Xu          , Xu          , Xu          , Xu          , Xu          , Xu          , Xu          , Xu          , Xu          , Xu          , Xu          , Qxu         , Qxu         , Qxu         , Xu          , Xu          , Xu          , Xu          , Xu          , Xu          , Xu          , Xu          , Xu          , Xu          , Xu          , Dd^Ft       , Xu          , Xu          , Xu          , Xu          , Xu          , Xu          , Xu          , Xu          , Xu          , Xu          , Xu          , Ss          , Xu          , Xu          , Xu          , Xu          , Qxu         , Qxu         
Qxu         , Qxu         , Xu          , Xu          , Xu          , Xu          , Xu          , Xu          , Ww          , Wwf         , Ww          , Chw         , Ww          , Ww          , Ww          , Xu          , Xu          , Xu          , Xu          , Xu          , Ss          , Ss          , Ss          , Ss          , Ss          , Ss          , Ss          , Xu          , Xu          , Xu          , Xu          , Xu          , Xu          , Xu          , Xu          , Xu          , Xu          , Xu          , Qxu         , Qxu         , Re          , Re          , Aa^Fpa      , Qxu         , Qxu         , Xu          , Xu          , Xu          , Xu          , Xu          , Xu          , Xu          , Dd          , Dd^Ft       , Dd          , Dd^Ft       , Hd          , Xu          , Xu          , Xu          , Xu          , Xu          , Xu          , Xu          , Ss          , Ss          , Ss          , Gg          , Xu          , Xu          , Xu          , Qxu         , Qxu         
Qxu         , Qxu         , Xu          , Xu          , Xu          , Xu          , Ww          , Ww          , Ww          , Wwf         , Ww          , Ww          , Ww          , Ww          , Ww          , Ds          , Ds          , Xu          , Gs^Fp       , Gs^Fp       , Gs^Fp       , Ss          , Mm          , Gs^Fp       , Gs^Fp       , Ss          , Ss          , Ss          , Ss          , Xu          , Xu          , Xu          , Xu          , Xu          , Xu          , Xu          , Ha          , Qxu         , Re          , Re          , Qxu         , Qxu         , Qxu         , Re          , Aa^Fpa      , Qxu         , Qxu         , Xu          , Xu          , Xu          , Dd          , Dd          , Dd          , Dd          , Hd          , Dd          , Dd          , Md          , Md          , Xu          , Xu          , Xu          , Xu          , Xu          , Ss          , Ss          , Ss          , Ss          , Xu          , Xu          , Xu          , Qxu         , Qxu         
Qxu         , Qxu         , Xu          , Xu          , Ww          , Ww          , Ww          , Ww          , Ww          , Gs^Ft       , Gs^Ft       , Ww          , Hh          , Ww          , Ww          , Ds          , Ds          , Xu          , Gs^Fp       , Gg          , Ggf         , Hh          , Gg          , Gg          , Ggf         , Gs^Fp       , Hh          , Ss          , Ss          , Ss          , Ss          , Xu          , Xu          , Xu          , Ms          , Ms          , Ha          , Aa^Fpa      , Re          , Qxu         , Xu          , Xu          , Xu          , Qxu         , Qxu         , Re          , Qxu         , Xu          , Dd          , Dd          , Dd          , Dd^Ft       , Dd          , Hd          , Md          , Hd          , Dd          , Dd^Ft       , Dd^Ft       , Md          , Hd          , Xu          , Ss          , Ss          , Xu          , Ss          , Xu          , Xu          , Xu          , Xu          , Xu          , Qxu         , Qxu         
Qxu         , Qxu         , Xu          , Ww          , Ww          , Ww          , Wwf         , Wwf         , Wwf         , Ww          , Ww          , Gs^Ft       , Wwf         , Wwf         , Ww^Bw\      , Ww          , Ww          , Xu          , Ss          , Gs^Fp       , Xu          , Gg          , Ggf         , Hh          , Mm          , Ggf         , Gg          , Mm          , Gs^Fp       , Ss          , Ss          , Ss          , Xu          , Ha          , Ha          , Ms          , Aa^Fpa      , Aa^Fpa      , Aa          , Re          , Re          , Re          , Re          , Xu          , Qxu         , Re          , Qxu         , Xu          , Dd          , Dd^Ft       , Dd          , Dd          , Dd          , Dd          , Gs          , Dd          , Gs          , Dd          , Dd^Ft       , Dd^Ft       , Gs          , Gs          , Xu          , Xu          , Xu          , Xu          , Xu          , Xu          , Xu          , Xu          , Xu          , Qxu         , Qxu         
Qxu         , Qxu         , Xu          , Ww          , Gs^Ft       , Wwf         , Hh          , Mm          , Mm          , Wwf         , Wwf         , Wwf         , Ww          , Ww          , Xu          , Ww^Bw|      , Ww          , Xu          , Ss          , Ss          , Ss          , Xu          , Gs^Fp       , Gg          , Gg          , Hh          , Gg          , Gs^Fp       , Xu          , Xu          , Ss          , Ss          , Xu          , Aa          , Aa          , Aa          , Aa          , Aa          , Aa          , Aa          , Ha          , Ha          , Ha          , Re          , Re          , Re          , Qxu         , Xu          , Dd          , Dd          , Md          , Hd          , Gs          , Gs          , Gg          , Gs          , Gg          , Gs          , Gs          , Gs          , Gg          , Gg          , Xu          , Xu          , Xu          , Xu          , Uu^Uf       , Xu          , Xu          , Xu          , Xu          , Qxu         , Qxu         
Qxu         , Qxu         , Xu          , Gs^Ft       , 2 Gs        , Wwf         , 3 Gs        , Xu          , Xu          , Hh          , Wwf         , Gs^Ft       , Mm^Xm       , Xu          , Ww          , Ww^Bw|      , Ww          , Xu          , Chs         , Ww^Bw/      , Ww^Bw\      , Xu          , Gg          , Gg          , Gg          , Gg          , Xu          , Xu          , Xu          , Ss          , Ss          , Ss          , Xu          , Aa          , Aa          , Aa          , Aa^Fpa      , Aa          , Aa          , Ha          , Ms          , Ms          , Ms          , Ha          , Re          , Re          , Qxu         , Xu          , Cud         , Dd          , Gs          , Hd          , Gs          , Gg          , Gg          , Gg          , Hh          , Gs^Fp       , Hh          , Gg          , Gg          , Mm          , Xu          , Xu          , Uu^Uf       , Uh          , Uu          , Uh          , Cud         , Xu          , Xu          , Qxu         , Qxu         
Qxu         , Qxu         , Xu          , Gs          , Gs          , Wwf         , Gs          , Cud         , Cud         , Xu          , Wwf         , Hh          , Ww          , Ww          , Ww          , Ww^Bw\      , Chw         , Xu          , Chs         , Ss          , Ss          , Gs^Fp       , Gg          , Hh          , Ggf         , Xu          , Wwf         , Wwf         , Xu          , Ss          , Ss          , Ss          , Xu          , Chr         , Aa          , Aa^Fpa      , Ha          , Aa^Fpa      , Chr         , Ha          , Ms          , Ms^Xo       , Ms          , Ha          , Re          , Re          , Cud         , Xu          , Cud         , Cud         , Gg          , Gs          , Gg          , Gg          , Gs^Fp       , Gs^Fp       , Ss          , Ss          , Gs^Fp       , Gg          , Gg          , Gg          , Uu          , Uh          , Uu          , Uu          , Cud         , Cud         , Cud         , Cud         , Xu          , Qxu         , Qxu         
Qxu         , Qxu         , Xu          , Gs          , Gs          , 1 Wwf       , Gs          , Cud         , Cud         , Cud         , Wwf         , Mm          , Ww          , Ww          , Ww          , Chw         , Chw         , 6 Kh        , Chs         , Ss          , Ss          , Gg          , Gg          , Mm          , Gg          , Wwf         , Wwf         , Wwf         , Xu          , Ss          , Chs         , Chs         , 7 Kh        , Chr         , Aa          , Ms          , Ha          , Ms          , Chr         , Chr         , Ms          , Ms^Xo       , Ms          , Ha          , Re          , Cud         , Cud         , 8 Kud       , Cud         , Cud         , Gg          , Gg          , Ch          , Mm          , Ss          , Ss          , Ss          , Ss          , Gg^Fet      , Gg          , Gg          , Gg          , Cud         , Uu          , Uu          , Cud         , Cud         , Cud         , 9 Kud       , Cud         , Xu          , Qxu         , Qxu         
Qxu         , Qxu         , Xu          , Gs          , 4 Gs        , Wwf         , 5 Gs        , Cud         , Xu          , Xu          , Wwf         , Hh          , Mm^Xm       , Ww          , Ww          , Ww^Bw/      , Ww          , Xu          , Chs         , Ss          , Ww^Bw/      , Gs^Fp       , Gg          , Hh          , Gg          , Xu          , Xu          , Wwf         , Xu          , Ss          , Ss          , Chs         , Xu          , Chr         , Aa          , Aa^Fpa      , Aa^Fpa      , Aa^Fpa      , Aa          , Ha          , Ms          , Ms^Xo       , Ms          , Ha          , Re          , Re          , Qxu         , Xu          , Cud         , Cud         , Gg          , Gg          , Gg          , Mm          , Gs^Fp       , Ss          , Ss          , Ss          , Gs^Fp       , Gg          , Gg          , Gg          , Uu          , Uu          , Uu          , Cud         , Cud         , Cud         , Cud         , Cud         , Xu          , Qxu         , Qxu         
Qxu         , Qxu         , Xu          , Gs^Ft       , Gs^Ft       , Wwf         , Hh          , Xu          , Mm          , Hh          , Wwf         , Gs^Ft       , Ww          , Xu          , Xu          , Ww^Bw|      , Ww          , Xu          , Ss          , Ww^Bw\      , Ss          , Xu          , Gs^Fp       , Gg          , Gg          , Ggf         , Ggf         , Xu          , Xu          , Ss          , Ss          , Ss          , Xu          , Chr         , Aa          , Aa          , Aa          , Aa          , Aa          , Ha          , Ha          , Ms          , Ha          , Ha          , Re          , Re          , Qxu         , Xu          , Dd          , Gs          , Gs          , Gs          , Gs          , Gg          , Gg          , Gs^Fp       , Hh          , Ss          , Hh          , Gg          , Gg          , Gg          , Xu          , Uh          , Uu^Uf       , Uu          , Uu          , Cud         , Cud         , Cud         , Xu          , Qxu         , Qxu         
Qxu         , Qxu         , Xu          , Ww          , Ww          , Wwf         , Wwf         , Mm          , Wwf         , Wwf         , Ww          , Wwf         , Wwf         , Ww          , Ww^Bw/      , Ww^Bw|      , Ww          , Xu          , Ss          , Ss          , Xu          , Xu          , Gg          , Gg          , Mm          , Hh          , Gg          , Gs^Fp       , Gs^Fp       , Xu          , Ss          , Ss          , Xu          , Aa          , Ha          , Aa          , Aa^Fpa      , Aa          , Aa          , Aa          , Re          , Ha          , Re          , Re          , Qxu         , Re          , Qxu         , Xu          , Dd          , Dd          , Md          , Hd          , Gs          , Gg          , Gg          , Gg          , Gg          , Gs^Fp       , Gs          , Gg          , Gg          , Mm          , Xu          , Xu          , Xu          , Uh          , Uu^Uf       , Uh          , Xu          , Xu          , Xu          , Qxu         , Qxu         
Qxu         , Qxu         , Xu          , Ww          , Ww          , Ww          , Ww          , Wwf         , Ww          , Ww          , Gs^Ft       , Gs^Ft       , Hh          , Wwf         , Ww          , Ww          , Ds          , Xu          , Gs^Fp       , Gs^Fp       , Gg          , Ggf         , Gg          , Hh          , Gg          , Ggf         , Hh          , Mm          , Ss          , Ss          , Ss          , Ss          , Xu          , Ha          , Ms          , Ms          , Ha          , Aa^Fpa      , Re          , Re          , Xu          , Re          , Xu          , Xu          , Qxu         , Re          , Qxu         , Xu          , Dd          , Dd          , Dd          , Hd          , Dd          , Gs          , Gs          , Gs          , Gs          , Gs          , Dd^Ft       , Gs          , Gs          , Gg          , Xu          , Xu          , Xu          , Xu          , Xu          , Xu          , Xu          , Xu          , Xu          , Qxu         , Qxu         
Qxu         , Qxu         , Xu          , Xu          , Xu          , Ww          , Ww          , Ww          , Ww          , Gs^Ft       , Ww          , Ww          , Ww          , Ww          , Ww          , Ds          , Ds          , Xu          , Gs^Fp       , Gg          , Gs^Fp       , Hh          , Mm          , Gg          , Gs^Fp       , Gs^Fp       , Ss          , Ss          , Ss          , Ss          , Xu          , Xu          , Xu          , Xu          , Xu          , Ms          , Ha          , Aa^Fpa      , Re          , Qxu         , Qxu         , Xu          , Qxu         , Qxu         , Aa^Fpa      , Re          , Qxu         , Xu          , Dd          , Dd^Ft       , Dd          , Dd          , Dd          , Dd          , Md          , Dd          , Dd          , Dd          , Dd^Ft       , Dd^Ft       , Hd          , Gs          , Ss          , Xu          , Xu          , Xu          , Xu          , Xu          , Xu          , Xu          , Xu          , Qxu         , Qxu         
Qxu         , Qxu         , Xu          , Xu          , Xu          , Xu          , Xu          , Ww          , Ww          , Wwf         , Ww          , Ww          , Ww          , Ww          , Ww          , Ds          , Xu          , Xu          , Xu          , Gs^Fp       , Ss          , Ss          , Ss          , Gs^Fp       , Ss          , Ss          , Ss          , Ss          , Xu          , Xu          , Xu          , Xu          , Xu          , Xu          , Xu          , Xu          , Xu          , Qxu         , Qxu         , Re          , Re          , Qxu         , Aa^Fpa      , Re          , Qxu         , Qxu         , Xu          , Xu          , Xu          , Dd          , Dd          , Dd^Ft       , Dd          , Hd          , Hd          , Hd          , Dd          , Dd^Ft       , Md          , Md          , Xu          , Xu          , Xu          , Ss          , Ss          , Ss          , Ss          , Xu          , Xu          , Xu          , Xu          , Qxu         , Qxu         
Qxu         , Qxu         , Xu          , Xu          , Xu          , Xu          , Xu          , Xu          , Xu          , Wwf         , Chw         , Chw         , Chw         , Ww          , Xu          , Xu          , Xu          , Xu          , Xu          , Xu          , Xu          , Ss          , Ss          , Ss          , Ss          , Ss          , Xu          , Xu          , Xu          , Xu          , Xu          , Xu          , Xu          , Xu          , Xu          , Xu          , Xu          , Xu          , Xu          , Qxu         , Qxu         , Re          , Qxu         , Qxu         , Xu          , Xu          , Xu          , Xu          , Xu          , Xu          , Xu          , Dd          , Dd          , Dd          , Dd          , Dd          , Hd          , Md          , Xu          , Xu          , Xu          , Xu          , Xu          , Xu          , Ss          , Ss          , Ss          , Ss          , Xu          , Xu          , Xu          , Qxu         , Qxu         
Qxu         , Qxu         , Xu          , Xu          , Xu          , Xu          , Xu          , Xu          , Xu          , Xu          , Xu          , Chw         , Xu          , Xu          , Xu          , Xu          , Xu          , Xu          , Xu          , Xu          , Xu          , Xu          , Xu          , Ss          , Xu          , Xu          , Xu          , Xu          , Xu          , Xu          , Xu          , Xu          , Xu          , Xu          , Xu          , Xu          , Xu          , Xu          , Xu          , Xu          , Xu          , Qxu         , Xu          , Xu          , Xu          , Xu          , Xu          , Xu          , Xu          , Xu          , Xu          , Xu          , Xu          , Dd^Ft       , Dd^Ft       , Dd^Ft       , Xu          , Xu          , Xu          , Xu          , Xu          , Xu          , Xu          , Xu          , Xu          , Ss          , Ss          , Gg          , Xu          , Xu          , Xu          , Qxu         , Qxu         
Qxu         , Qxu         , Qxu         , Xu          , Xu          , Xu          , Xu          , Xu          , Xu          , Xu          , Xu          , Xu          , Xu          , Xu          , Xu          , Xu          , Xu          , Xu          , Xu          , Xu          , Xu          , Xu          , Xu          , Xu          , Xu          , Xu          , Xu          , Xu          , Xu          , Xu          , Xu          , Xu          , Xu          , Xu          , Xu          , Xu          , Xu          , Xu          , Xu          , Xu          , Xu          , Xu          , Xu          , Xu          , Xu          , Xu          , Xu          , Xu          , Xu          , Xu          , Xu          , Xu          , Xu          , Xu          , Xu          , Xu          , Xu          , Xu          , Xu          , Xu          , Xu          , Xu          , Xu          , Xu          , Xu          , Xu          , Xu          , Xu          , Xu          , Xu          , Qxu         , Qxu         , Qxu         
Qxu         , Qxu         , Qxu         , Qxu         , Qxu         , Qxu         , Qxu         , Qxu         , Qxu         , Qxu         , Qxu         , Qxu         , Qxu         , Qxu         , Qxu         , Qxu         , Qxu         , Qxu         , Qxu         , Qxu         , Qxu         , Qxu         , Qxu         , Qxu         , Qxu         , Qxu         , Qxu         , Qxu         , Qxu         , Qxu         , Qxu         , Qxu         , Qxu         , Qxu         , Qxu         , Qxu         , Qxu         , Qxu         , Qxu         , Qxu         , Qxu         , Qxu         , Qxu         , Qxu         , Qxu         , Qxu         , Qxu         , Qxu         , Qxu         , Qxu         , Qxu         , Qxu         , Qxu         , Qxu         , Qxu         , Qxu         , Qxu         , Qxu         , Qxu         , Qxu         , Qxu         , Qxu         , Qxu         , Qxu         , Qxu         , Qxu         , Qxu         , Qxu         , Qxu         , Qxu         , Qxu         , Qxu         , Qxu         
Qxu         , Qxu         , Qxu         , Qxu         , Qxu         , Qxu         , Qxu         , Qxu         , Qxu         , Qxu         , Qxu         , Qxu         , Qxu         , Qxu         , Qxu         , Qxu         , Qxu         , Qxu         , Qxu         , Qxu         , Qxu         , Qxu         , Qxu         , Qxu         , Qxu         , Qxu         , Qxu         , Qxu         , Qxu         , Qxu         , Qxu         , Qxu         , Qxu         , Qxu         , Qxu         , Qxu         , Qxu         , Qxu         , Qxu         , Qxu         , Qxu         , Qxu         , Qxu         , Qxu         , Qxu         , Qxu         , Qxu         , Qxu         , Qxu         , Qxu         , Qxu         , Qxu         , Qxu         , Qxu         , Qxu         , Qxu         , Qxu         , Qxu         , Qxu         , Qxu         , Qxu         , Qxu         , Qxu         , Qxu         , Qxu         , Qxu         , Qxu         , Qxu         , Qxu         , Qxu         , Qxu         , Qxu         , Qxu         
