border_size=1
usage=map

Chs         , Chs         , Chs         , Chs         , Chs         , Ss          , Ss          , Ss          , Ss          , Ss^Bw|      , Ss          , Ss          , Ss          , Ss          , Ss          , Ss          , Ss          , Ss          , Ss          , Ss          , Ss          , Ss          , Ss^Bw/      , Ss^Bw/
Chs         , Chs         , Chs         , Chs         , Chs         , Ss          , Ss          , Ss          , Ss          , Ss^Bw|      , Ss          , Ss          , Ss          , Ss          , Ss          , Ss          , Gg          , Gg          , Hh          , Gg          , Gg          , Gg          , Gg          , Gg
Chs         , Chs         , 9 Khs       , Chs         , Chs         , Chs         , Ss          , Ss          , Hh          , Gg          , Hh          , Ss          , Ss          , Ss          , Gg          , Hh          , Gs^Fp       , Gg          , Gg          , Gs^Fp       , Gg          , Gs^Fp       , Gg          , Gg
Chs         , Chs         , Chs         , Chs         , Chs         , Chs         , Gg          , Gg          , Gs^Fp       , Gg          , Gs^Fp       , Gg          , Gg          , Gs^Fp       , Gg          , Gg          , Gg          , Gg          , Gg          , Gs^Fp       , Gg          , Hh          , Gs^Fp       , Gg
Chs         , Chs         , Chs         , Chs         , Chs         , Gg          , Gg          , Gs^Fp       , Gg          , Gs^Fp       , Gg          , Gg          , Hh          , Gg          , Gg          , Gs^Fp       , Gs^Fp       , Gs^Fp       , Hh          , Gg          , Gs^Fp       , Gg          , Gg          , Gg
Xu          , Xu          , Xu          , Xu          , Xu          , Xu          , Xu          , Xu          , Xu          , Xu          , Xu          , Xu          , Xu          , Xu          , Xu          , Xu          , Xu          , Gg          , Gs^Fp       , Gg          , Gg          , Gg          , Gg          , Gg
Xu          , Cud         , Cud         , Cud         , Cud         , Uu          , Uu          , Uu          , Uh          , Uu          , Uu          , Uu          , Uu          , Uh          , Uu^Ii       , Uh^Ii       , Uu^Ii       , Xu          , Xu          , Ww          , Ww          , Ww          , Wwf         , Ww
Xu          , Cud         , 8 Kud       , Cud         , Cud         , Cud         , Uu          , Uh          , Uu          , Uu          , Uh          , Qxu         , Uu          , Uh          , Uu          , Uu^Ii       , Uh^Ii       , Uh^Ii       , Xu          , Ww          , Ww          , Wo          , Ww          , Ww
Xu          , Cud         , Cud         , Cud         , Cud         , Cud         , Uu          , Uu          , Uh          , Uu          , Uu          , Uu          , Uu          , Uu          , Uu          , Uu          , Uh          , Uu^Ii       , Xu          , Ww^Bw|      , Ww          , Ww          , Ww          , Ww
Xu          , Cud         , Cud         , Cud         , Xu          , Uu          , Xu          , Qxu         , Xu          , Uu          , Xu          , Uu          , Xu          , Uu          , Uh          , Uu          , Uu          , Uu          , Xu          , Wo          , Ww          , Ww          , Wo          , Ww
Wo          , Xu          , Xu          , Xu          , Gg          , Xu          , Xu          , Xu          , Xu          , Xu          , Xu          , Xu          , Uu          , Uh          , Uu          , Uu          , Qxu         , Uu          , Xu          , Ww          , Wwf         , Ww          , Ww          , Ww
Wo          , Ww          , Wo          , Xu          , Wwf         , Xu          , Xu          , Xu          , Xu          , Xu          , Uu          , Uh          , Uu          , Uu          , Uu          , Uu          , Uu          , Uu          , Xu          , Ww          , Ai          , Ww          , Ai          , Ww
Wo          , Ww          , Wwf         , Ww          , Wo          , Wo          , Xu          , Xu          , Uu          , Uu          , Uu          , Uu          , Uu          , Uh          , Uu          , Uu          , Xu          , Xu          , Ai          , Ai          , Ai          , Ai          , Ai          , Ai
Wo          , Wo          , Ww          , Wo          , Wo          , Wo          , Xu          , Uu^Ii       , Uu^Ii       , Uh^Ii       , Uu^Ii       , Uu          , Xu          , Qxu         , Xu          , Xu          , Aa          , Ha          , Aa          , Aa          , Aa          , Aa          , Ha          , Ai
Wo          , Wo          , Ww          , Wo          , Wo          , Xu          , Gg          , Gg          , Gg          , Gg          , Xu          , Xu          , Xu          , Xu          , Aa          , Aa          , Aa          , Aa          , Ha          , Aa          , Ha          , Aa          , Aa          , Mm
Wo          , Ww          , Wo          , Wo          , Ww          , Xu          , Xu          , Gg          , Cv          , Cv          , Cv          , Xu          , Gg          , Gg          , Gg          , Aa          , Aa          , Aa          , Aa          , Aa          , Aa          , Aa          , Ha          , Mm
Wo          , Ww          , Ww          , Ww          , Xu          , Ww          , Xu          , Xu          , Cv          , Cv          , 7 Kv        , Cv          , Cv          , Gg          , Gg          , Gg          , Xu          , Xu          , Xu          , Xu          , Xu          , Xu          , Xu          , Xu
Wo          , Wo          , Xu          , Xu          , Gs^Ft       , Xu          , Gs^Ft       , Gg^Fet      , Dd          , Cv          , Cv          , Cv          , Cv          , Cv          , Xu          , Xu          , Xu          , Xu          , Xu          , Xu          , Xu          , Xu          , Xu          , Xu
Xu          , Xu          , Ds          , Dd          , Dd          , Gs^Ft       , Hd          , Dd          , Gs^Ft       , Dd          , Gg^Fet      , Cv          , Xu          , Xu          , Dd^Do       , Xu          , Xu          , Xu          , Xu          , Xu          , Xu          , Xu          , Xu          , Xu
Xu          , Xu          , Dd          , Dd          , Xu          , Gs^Ft       , Gs^Ft       , Gs^Ft       , Gs^Ft       , Dd          , Dd          , Gs^Ft       , Md          , Dd          , Gs^Ft       , Dd          , Dd          , Gs^Ft       , Gs^Ft       , Xu          , Gs^Ft       , Xu          , Gg          , Xu
Xu          , Xu          , Xu          , Dd          , Dd          , Xu          , Xu          , Md          , Hd          , Gs^Ft       , Gs^Ft       , Hd          , Gs^Ft       , Dd          , Ds          , Dd^Dc       , Gs^Ft       , Gs^Ft       , Dd          , Gg          , Gs^Ft       , Gg          , Gs^Ft       , Gg
Xu          , Xu          , Xu          , Xu          , Xu          , Dd          , Dd          , Xu          , Xu          , Dd          , Dd          , Ds          , Ds          , Gs^Ft       , Gs^Ft       , Ds          , Ds          , Gs^Ft       , Gs^Ft       , Dd          , Gs^Ft       , Dd          , Gs^Ft       , Gg
Xu          , Xu          , Xu          , Xu          , Xu          , Xu          , Xu          , Dd          , Xu          , Dd^Do       , Xu          , Ds          , Xu          , Hd          , Xu          , Ds          , Xu          , Dd          , Gs^Ft       , Gg          , Gs^Ft       , Gg          , Dd          , Gg
Xu          , Xu          , 3 Kh        , Rr          , 4 Kh        , Xu          , Xu          , Xu          , Rd          , Xu          , Hh          , Xu          , Gg          , Xu          , Re          , Xu          , Gg          , Gs^Ft       , Gg          , Gg          , Gg          , Gg          , Gg          , Gg
Xu          , Xu          , Rr          , Rr          , Rr          , Xu          , Rp          , Rd          , Ce          , Rd          , Re          , Gs^Fp       , Re          , Ggf         , Hh          , Gs^Fp       , Gg          , Gs^Fp       , Gg          , Gs^Fp       , Gs^Fp       , Gg          , Gg          , Gg
Xu          , Xu          , Rr          , Rr          , Rp          , Rp          , Ce          , Rd          , Rd          , Rd          , Ggf         , Re          , Re          , Gg          , Re          , Re          , Gg          , Gg          , Gs^Fp       , Gg          , Gg          , Gs^Fp       , Gg          , Gg
Xu          , Xu          , Rr          , Rr          , Rr          , Rp          , Rp          , Rd          , Ce          , Rd          , Re          , Ggf         , Hh          , Gs^Fp       , Ggf         , Re          , Mm          , Gg          , Gg          , Mm          , Hh          , Mm          , Gg          , Gg
Xu          , Xu          , 2 Kh        , Rr          , 5 Kh        , Xu          , Xu          , Rd          , Xu          , Rd          , Xu          , Gs^Fp       , Xu          , Re          , Xu          , Re          , Xu          , Hh          , Hh          , Gg          , Gg          , Gg          , Mm          , Mm^Xm
Xu          , Xu          , Rr          , Rr          , Rr          , Xu          , Chr         , Xu          , Chr         , Xu          , Mm          , Xu          , Gg          , Xu          , Gg          , Xu          , Gg          , Xu          , Gg          , Gg          , Hh          , Mm          , Mm          , Mm^Xm
Xu          , Xu          , Xu          , 1 Kh        , Xu          , Xu          , 6 Khr       , Chr         , Chr         , Gg          , Gg          , Gg          , Gg          , Hh          , Gg          , Hh          , Gg          , Gg          , Hh          , Gg          , Mm          , Mm          , Mm          , Mm^Xm
Xu          , Xu          , Xu          , Xu          , Gg          , Chr         , Chr         , Chr         , Chr         , Hh          , Gg          , Mm          , Gg          , Gg          , Hh          , Gg          , Mm          , Mm          , Hh          , Mm          , Mm          , Hh          , Mm          , Mm^Xm
Xu          , Xu          , Xu          , Xu          , Xu          , Chr         , Chr         , Chr         , Chr         , Hh          , Gg          , Gg          , Mm          , Mm          , Mm          , Mm          , Mm          , Mm          , Mm          , Mm          , Mm^Xm       , Mm^Xm       , Mm^Xm       , Mm^Xm
