border_size=1
usage=map

Qxu         , Qxu         , Qxu         , Qxu         , Qxu         , Qxu         , Qxu         , Qxu         , Qxu         , Qxu         , Qxu         , Qxu         , Qxu         , Qxu         , Qxu         , Qxu         , Qxu         , Qxu         , Qxu         , Qxu         , Qxu         , Qxu         , Qxu         , Qxu         , Qxu         
Qxu         , Gg          , Gg          , Gg          , Gg          , Gg          , Gs^Ft       , Gg          , Gg          , Gg          , Gs          , Gg          , Xu          , Gg          , Gs          , Ss          , Ss          , Ss          , Ss          , Ss          , Dd          , Ss          , Ss          , Ss          , Qxu         
Qxu         , Gg          , Gs^Ft       , Gg          , Gs^Ft       , Gs^Ft       , Gs^Fdw      , Gs^Fdw      , Gs^Fp       , Gs          , Gs^Fdf      , Gs          , Xu          , Gs          , Gs          , Gs          , Ss          , Gs          , Ss          , Dd          , Ss          , Dd          , Ss          , Ss          , Qxu         
Qxu         , Gg          , Gg          , Gg          , Gs^Fdw      , Gs^Fdw      , Hh^Fms      , Gs^Fp       , Gg          , Gs^Fp       , Gs^Fdf      , Hh^Fmw      , Xu          , Ss          , Gg          , Gs          , Gg          , Ss          , Ds          , Hh          , Ss          , Dd          , Dd          , Gs^Fdf      , Qxu         
Qxu         , Gg          , Xu          , Gg          , Xu          , Gs          , Gs          , Gs^Fds      , Gs^Fdf      , Gs^Fdf      , Gs^Ft       , Gg          , Xu          , Ss          , Xu          , Gs          , Xu          , Ss          , Ss          , Dd          , Dd          , Ds          , Dd^Dc       , Ss          , Qxu         
Qxu         , Xu          , Co          , 6 Ko        , Co          , Xu          , Xu          , Ggf         , Gs^Fdf      , Gs^Ft       , Gs^Fdw      , Gs          , Xu          , Xu          , Cud         , 8 Kud       , Cud         , Xu          , Xu          , Ggf         , Ss          , Dd          , Dd          , Ss          , Qxu         
Qxu         , Co          , Co          , Co          , Co          , Co          , Xu          , Gg          , Gs^Fdf      , Gs^Fdw      , Gs^Fdw      , Hh^Fdf      , Xu          , Cud         , Cud         , Cud         , Cud         , Cud         , Xu          , Ss          , Hh^Fds      , Dd          , Dd          , Dd          , Qxu         
Qxu         , Gg          , Gg          , Co          , Gg          , Gg          , Xu          , Gg          , Gs^Fdw      , Gs^Fdw      , Gs^Fp       , Gg          , Xu          , Gg          , Gs          , Cud         , Gg          , Ggf         , Xu          , Ss          , Dd          , Dd          , Dd          , Dd          , Qxu         
Qxu         , Gs          , Gs          , Gg          , Ggf         , Gs          , Xu          , Gs^Fdw      , Gs^Fdw      , Gg          , Gg          , Gs^Fp       , Xu          , Mm          , Hh          , Gs          , Gs^Fdf      , Gg          , Xu          , Ss          , Dd          , Ss          , Hh          , Ss          , Qxu         
Qxu         , Gg          , Gs^Fp       , Gg          , Gs^Ft       , Gg          , Xu          , Gg          , Hh^Fds      , Hh^Fmw      , Gs^Fp       , Gs^Fp       , Xu          , Mm          , Mm          , Gg          , Gg          , Hh^Fdf      , Xu          , Dd          , Ss          , Ds          , Ss          , Gs          , Qxu         
Qxu         , Gg          , Hh          , Gg          , Gs          , Gs^Fp       , Xu          , Gg          , Gs^Ft       , Gg          , Gs^Fp       , Gg          , Xu          , Gg          , Hh          , Ggf         , Hh          , Gg          , Xu          , Dd^Dc       , Dd          , Ds          , Ds          , Ss          , Qxu         
Qxu         , Hh          , Gs          , Gg          , Gg          , Gg          , Xu          , Gs^Fds      , Gs^Fds      , Gs^Fp       , Gs          , Gs          , Xu          , Gs^Fds      , Gg          , Hh          , Hh          , Gg          , Xu          , Ss          , Gs          , Dd          , Ds          , Ss          , Qxu         
Qxu         , Gg          , Ggf         , Gg          , Hh^Fds      , Gg          , Xu          , Gg          , Gs^Fds      , Gg          , Gs^Fds      , Hh^Fms      , Xu          , Gg          , Mm          , Hh          , Mm          , Mm          , Xu          , Ss          , Ds          , Dd          , Gs^Fdf      , Ds          , Qxu         
Qxu         , Gg          , Gg          , Gg          , Gs          , Gg          , Xu          , Gs^Fdf      , Gg          , Gs^Fds      , Hh^Fds      , Gs^Fds      , Xu          , Hh          , Gg          , Gs          , Hh          , Mm          , Xu          , Ds          , Ss          , Dd          , Ss          , Gs          , Qxu         
Qxu         , Gs^Fds      , Gg          , Ggf         , Gs          , Gg          , Xu          , Gs^Fdf      , Gs^Fp       , Ggf         , Gs^Fdw      , Gg          , Xu          , Hh          , Gg          , Hh^Fmw      , Hh          , Gs^Fmw      , Xu          , Ds          , Dd^Do       , Dd          , Dd          , Ss          , Qxu         
Qxu         , Gg          , Gg          , Gs^Fdf      , Ggf         , Gs          , Xu          , Gs^Fdf      , Hh^Fdf      , Gs^Fdw      , Gs^Fdw      , Gg          , Xu          , Hh          , Hh          , Hh          , Gs          , Gs^Fmw      , Xu          , Ds          , Dd          , Ss          , Dd          , Ss          , Qxu         
Qxu         , Gg          , Hh          , Gg          , Gg          , Gg          , Xu          , Gg          , Gs^Fdf      , Gs          , Gg          , Gs^Fds      , Xu          , Hh          , Hh          , Mm          , Gs          , Hh^Fmw      , Xu          , Hh          , Dd          , Ds          , Dd^Dc       , Dd          , Qxu         
Qxu         , Gg          , Gs          , Gs          , Gs^Fp       , Gg          , Xu          , Gg          , Gs^Fp       , Gs^Fdf      , Gs^Fdw      , Gs^Fds      , Xu          , Gg          , Hh^Fms      , Gg          , Gg          , Ggf         , Xu          , Dd          , Ds          , Ds          , Hh          , Ss          , Qxu         
Qxu         , Gg          , Gg          , Gs          , Hh          , Hh          , Xu          , Hh^Fdw      , Gg          , Gs^Fdw      , Gs^Fds      , Gs^Fds      , Xu          , Gs^Fmw      , Gg          , Hh          , Mm          , Hh          , Xu          , Dd          , Ds          , Gg          , Gs          , Gg          , Qxu         
Qxu         , Gg          , Hh^Fds      , Gg          , Gg          , Gg          , Xu          , Ggf         , Gs^Fdw      , Gs^Fdw      , Gs^Fdf      , Gg          , Xu          , Ggf         , Mm          , Gg          , Hh          , Mm          , Xu          , Dd          , Ds          , Ds          , Dd          , Dd          , Qxu         
Qxu         , Gg          , Gg          , Gg          , Gg          , Gg          , Xu          , Gs^Fdw      , Gs          , Gs          , Gs^Fdf      , Hh^Fdw      , Xu          , Gg          , Gg          , Mm          , Hh^Fms      , Gs          , Xu          , Ss          , Dd          , Dd          , Ds          , Ss          , Qxu         
Qxu         , Gs          , Hh          , Ggf         , Gs^Fp       , Gs^Fdf      , Xu          , Gs^Fdw      , Gg          , Gg          , Gs          , Gs^Fdf      , Xu          , Gg          , Hh^Fp       , Hh          , Gg          , Gs          , Xu          , Ss          , Dd          , Ss          , Gs          , Ss          , Qxu         
Qxu         , Gs          , Gs          , Gg          , Gg          , Ggf         , Xu          , Gg          , Cv          , Cv          , Cv          , Gg          , Xu          , Gg          , Hh          , Hh          , Gs          , Gs          , Xu          , Ggf         , Dd          , Ss          , Gs          , Ss          , Qxu         
Qxu         , Gg          , Gg          , Gg          , Hh          , Gs          , Xu          , Cv          , Cv          , Cv          , Cv          , Cv          , Xu          , Hh          , Gg          , Mm          , Gs          , Gs^Fmw      , Xu          , Ss          , Dd          , Ds          , Ds          , Ss          , Qxu         
Qxu         , Gg^Fet      , Gg          , Gg          , Gs          , Gg          , Xu          , Xu          , Xu          , 7 Kv        , Xu          , Xu          , Gs^Fdf      , Gg          , Hh^Fds      , Hh          , Gg          , Gg          , Xu          , Ss          , Dd          , Ds          , Ss          , Gg          , Qxu         
Qxu         , Gg          , Ggf         , Gg          , Ggf         , Gs          , Xu          , Gg          , Gg          , Gg          , Hh          , Gg          , Gg          , Gg          , Hh          , Gs          , Gg          , Mm          , Xu          , Ss          , Ce          , Ce          , Ce          , Dd^Dc       , Qxu         
Qxu         , Gg          , Gg          , Gg          , Gg          , Gg          , Xu          , Mm          , Gg          , Gg          , Hh          , Hh^Fp       , Mm          , Hh          , Mm          , Gs          , Gs          , Gs^Fms      , Xu          , Ss          , Ce          , Ce          , Ce          , Ss          , Qxu         
Qxu         , 1 Ch        , 2 Ch        , 3 Ch        , 4 Ch        , 5 Ch        , Xu          , Gg          , Mm          , Gs          , Gs          , Mm          , Mm          , Gg          , Gg          , Gg          , Gs^Fdf      , Gg          , Xu          , Ce          , Ce          , 9 Ke        , Ce          , Ce          , Qxu         
Qxu         , Qxu         , Qxu         , Qxu         , Qxu         , Qxu         , Qxu         , Qxu         , Qxu         , Qxu         , Qxu         , Qxu         , Qxu         , Qxu         , Qxu         , Qxu         , Qxu         , Qxu         , Qxu         , Qxu         , Qxu         , Qxu         , Qxu         , Qxu         , Qxu         
