border_size=1
usage=map

Gg          , Gg          , Gg          , Ggf         , Gg          , Gg          , Gg          , Ggf         , Xu          , Uu          , Uu          , Ql          , Ql          , Ql          , Uu          , Uu          , Uu          , Uu          , Uu          , Qlf         , Uu          , Uu          , Uu          , Uu          , Qlf         , Qlf         , Uu          , Cud         , Cud         , Cud         , Cud         
Ggf         , Gg          , Ggf         , Gg          , 1 Cv        , Gg          , Ggf         , Gg          , Xu          , Uu^Ii       , Uu^Ii       , Uu          , Uu          , Uu          , Uh          , Uu          , Uu          , Uh          , Uu          , Qlf         , Qlf         , Qlf         , Qlf         , Qlf         , Qlf         , Uh          , Uu          , Cud         , Cud         , Cud         , Ql          
Gg          , Gg          , 4 Cv        , Gg          , Rr          , Ggf         , 3 Cv        , Gg          , Xu          , Re          , Gg          , Uh^Ii       , Uu^Ii       , Uu          , Uu          , Uu^Uf       , Uu          , Uu          , Uu          , Uu          , Uu          , Uu          , Uu          , Uh          , Uu          , Qlf         , Cud         , Cud         , 6 Kud       , Cud         , Cud         
Gg          , Ggf         , Gg          , Rr          , Rr          , Rr          , Gg          , Gg          , Xu          , Hh          , Re^Uf       , Gg          , Re          , Uu^Ii       , Uh^Ii       , Uu          , Uu          , Uh          , Uu          , Uu          , Uh          , Uh          , Uu          , Uu          , Uu          , Uu          , Cud         , Cud         , Cud         , Cud         , Cud         
Gs          , Gg          , 2 Cv        , Rr          , Rr          , Rr          , 5 Cv        , Ggf         , Xu          , Re          , Re          , Re          , Gg          , Gg          , Re          , Uu^Ii       , Uu^Ii       , Uu          , Uu^Uf       , Uu          , Uu          , Uu          , Uu          , Uu          , Uu          , Uu          , Uu          , Cud         , Cud         , Cud         , Ql          
Gs          , Gs          , Gs          , Rr          , Gg^Wm       , Rr          , Gs          , Ggf         , Xu          , Gg          , Re          , Gg          , Hh          , Re          , Re          , Gg          , Xu          , Xu          , Xu          , Xu          , Xu          , Xu          , Xu          , Xu          , Xu          , Xu          , Xu          , Xu          , Xu          , Xu          , Xu          
Gs          , Gs^Fp       , Gs^Fp       , Rr          , Rr          , Rr          , Re          , Gs          , Xu          , Hh          , Gg          , Gg          , Re          , Gg          , Gg          , Xu          , Gg          , Gs^Fp       , Gg          , Gg          , Gg          , Gg          , Chr         , Chr         , Chr         , Chr         , Chr         , Chr         , 9 Khr       , Chr         , Ql          
Gs          , Gs^Fp       , Re          , Rr          , Rr          , Rr          , Gs^Fp       , Gs^Fp       , Xu          , Gs          , Re^Uf       , Gs          , Gs^Fp       , Re^Uf       , Gg          , Xu          , Ss          , Gg          , Gs^Fp       , Gg          , Ch          , Gg          , Chr         , Chr         , Chr         , Chr         , Chr         , Chr         , Chr         , Chr         , Xu          
Gs          , Gs^Fp       , Re          , Rr          , Rr          , Rr          , Gs^Fp       , Gs          , Xu          , Gs^Fp       , Hh          , Re          , Gg          , Re          , Re          , Xu          , Gg          , Gg          , Gg          , Gs^Fp       , Gg          , Gg          , Chr         , Chr         , Chr         , Chr         , Chr         , Chr         , Chr         , Chr         , Xu          
Gs          , Gs          , Gs^Fp       , Rr          , Rp          , Rr          , Re          , Gs^Fp       , Xu          , Re          , Gs^Fp       , Re          , Re          , Gs          , Gs          , Xu          , Gs^Fp       , Gg          , Mm          , Xu          , Xu          , Xu          , Xu          , Xu          , Xu          , Xu          , Xu          , Xu          , Xu          , Xu          , Xu          
Gs          , Gs          , Gs^Fp       , Rp          , Rp          , Rp          , Re          , Gs          , Gg          , Gg          , Gg          , Gg          , Hh          , Gs          , Gs^Fp       , Xu          , Gg          , Gg          , Gg          , Gg          , Xu          , Xu          , Xu          , Xu          , Xu          , Ggf         , Xu          , Xu          , Xu          , Xu          , Xu          
Gs          , Gs^Fp       , Re          , Rp          , Rp          , Rp          , Gs^Fp       , Gg          , Gs          , Gs^Fp       , Re          , Gs^Fp       , Gs^Fp       , Re          , Gs          , Xu          , Ss          , Gg          , Gg          , Gs^Fp       , Ss          , Xu          , Xu          , Xu          , Xu          , Xu          , Xu          , Xu          , Xu          , Xu          , Xu          
Gs          , Gs          , Gs^Fp       , Rp          , Rp          , Rp          , Gs          , Gs^Fp       , Gg          , Gs          , Gs^Fp       , Gg          , Gg          , Gg          , Gs^Fp       , Xu          , Gs          , Gs^Fp       , Gs          , Gs          , Gs^Fp       , Gs          , Gg          , Xu          , Xu          , Xu          , Xu          , Xu          , Xu          , Xu          , Mm^Xm       
Gs          , Gs^Fp       , Gs^Fp       , Rp          , Rp          , Rp          , Gs^Fp       , Gg          , Gs^Fp       , Gs          , Gg          , Gs          , Hh          , Gs^Fp       , Gg          , Xu          , Gg          , Gs          , Gs          , Gs          , Gs^Fp       , Gs^Fp       , Gg          , Xu          , Ch          , Ch          , Ch          , Ch          , Ch          , Ch          , Mm          
Gs          , Gs          , Re          , Rp          , Rd          , Rp          , Re          , Gg          , Xu          , Gg          , Hh          , Gg          , Gg          , Gg          , Gg          , Xu          , Ss          , Gg          , Mm          , Gs          , Gs          , Gs^Fp       , Ss          , Xu          , Ch          , Ch          , Ch          , 8 Kh        , Ch          , Ch          , Mm^Xm       
Gs          , Gs          , Re          , Rd          , Rd          , Rd          , Gs^Fp       , Gs^Fp       , Xu          , Xu          , Xu          , Gg          , Hh          , Gg          , Xu          , Xu          , Xu          , Gg          , Gg          , Gg          , Gs          , Gs^Fp       , Gg          , Xu          , Ch          , Ch          , Ch          , Ch          , Ch          , Ch          , Mm^Xm       
Gs          , Gs          , Gs^Fp       , Rd          , Rd          , Rd          , Gs          , Gs          , Xu          , Xu          , Xu          , Xu          , Xu          , Xu          , Ha          , Aa          , Ha          , Xu          , Gg          , Ggf         , Ggf         , Gs          , Gg          , Xu          , Gs          , Ch          , Gs          , Ch          , Gs          , Ch          , Mm          
Gs          , Gs          , Gs^Fp       , Rd          , Rd          , Rd          , Gs^Fp       , Gg          , Xu          , Xu          , Hd          , Ds          , Md          , Md^Xm       , Aa          , Aa          , Aa          , Xu          , Gs^Ft       , Gs^Ft       , Gs          , Gs^Fp       , Ggf         , Xu          , Mm          , Gs          , Gs          , Gg^Fet      , Hh          , Gs          , Mm          
Gg          , Gg          , Gs^Fp       , Re          , Re          , Gs^Fp       , Gg          , Gs^Fp       , Gg          , Xu          , Ds          , Ds          , Ds          , Md^Xm       , Aa          , Ha          , Aa          , Xu          , Gg          , Gs          , Gs          , Gg          , Ss          , Xu          , Hh          , Hh          , Mm          , Gs          , Hh          , Gs          , Mm^Xm       
Gg          , Gs          , Gs          , Re          , Gg          , Re          , Gg          , Gs          , Gg          , Xu          , Ds          , Hd          , Ds          , Md^Xm       , Aa          , Aa          , Aa          , Xu          , Ss          , Ggf         , Gg          , Gs          , Gs          , Xu          , Mm^Xm       , Gg^Fet      , Hh          , Hh          , Gs          , Gs          , Mm^Xm       
Gg          , Gg          , Gg          , Gs^Fp       , Re          , Re          , Gs^Fp       , Gs          , Hh          , Xu          , Ds          , Ds          , Ds          , Md^Xm       , Aa          , Ha          , Aa          , Xu          , Ggf         , Gs^Ft       , Mm          , Gg          , Gs^Ft       , Xu          , Hh          , Mm          , Gs          , Hh          , Mm          , Gs          , Mm          
Gg          , Hh          , Hh          , Re          , Re          , Gs^Fp       , Gg          , Hh          , Gg          , Xu          , Ds          , Hd          , Ds          , Md^Xm       , Aa          , Aa          , Aa          , Xu          , Gg          , Gg          , Ggf         , Gg          , Gs^Ft       , Xu          , Gs          , Gs          , Mm          , Mm^Xm       , Mm          , Hh          , Mm^Xm       
Gg          , Gs^Fp       , Gg          , Gg          , Re          , Re          , Gg          , Gg          , Hh          , Xu          , Ds          , Ds          , Ds          , Md^Xm       , Aa          , Ha          , Aa          , Xu          , Gs^Ft       , Ggf         , Gs^Ft       , Gs          , Ss          , Xu          , Hh          , Hh          , Gs^Fp       , Hh          , Gs          , Gg^Fet      , Mm          
Gs^Fp       , Hh          , Gg          , Gg          , Gs^Fp       , Gg          , Hh          , Gg          , Gg          , Xu          , Ds          , Hd          , Ds          , Md^Xm       , Aa          , Aa          , Aa          , Xu          , Gg          , Gg          , Gs          , Gg          , Gs          , Xu          , Mm^Xm       , Mm          , Mm          , Hh          , Hh          , Gs          , Mm          
Hh          , Gs^Fp       , Gg          , Gs^Fp       , Re          , Gg          , Gg          , Gg          , Gg          , Xu          , Ds          , Ds          , Ss          , Ss          , Ss          , Ha          , Aa          , Xu          , Ss          , Gg          , Gg          , Mm          , Gg          , Xu          , Hh          , Mm          , Hh          , Gs          , Gs          , Mm          , Mm          
Hh          , Gg          , Hh          , Gg          , Re          , Gg          , Gs^Fp       , Gg          , Hh          , Gg          , Ss          , Ss          , Ss          , Ss          , Ss          , Ss          , Ss          , Xu          , Gg          , Gs^Ft       , Gs          , Gg          , Gs^Ft       , Xu          , Hh          , Hh          , Hh          , Hh          , Hh          , Gs          , Mm          
Gg          , Gg          , Gg          , Gg          , Hh          , Gg          , Gg          , Gg          , Gg          , Gg          , Ss^Bw/      , Ss          , Ss          , Ss^Bw/      , Ss          , Ss          , Ss          , Xu          , Gs          , Mm          , Gs^Ft       , Gs^Ft       , Gg          , Xu          , Gs          , Hh          , Mm          , Mm          , Gs          , Gg^Fet      , Mm^Xm       
Gg          , Gg          , Gg          , Hh          , Gg          , Gg          , Gs^Fp       , Gg          , Gg          , Gg          , Ss          , Ss          , Ss^Bw|      , Ss          , Ss          , Ss          , Chs         , Xu          , Gg          , Gs          , Gs          , Gs          , Gs^Ft       , Xu          , Hh          , Gg^Fet      , Mm          , Mm^Xm       , Hh          , Hh          , Mm          
Gg          , Gg          , Gg          , Gs^Fp       , Gg^Wm       , Gg          , Gg          , Gg          , Gg          , Gg          , Xu          , Ss          , Xu          , Ss          , Xu          , Ss          , Xu          , Xu          , Gs          , Gs^Ft       , Hh          , Gs          , Gs^Ft       , Xu          , Gs          , Hh          , Gs          , Hh          , Mm          , Gs^Fp       , Mm^Xm       
Gs^Ft       , Gg          , Hh          , Gg          , Gg          , Gg          , Gg          , Hh          , Gs^Ft       , Xu          , Gs          , Xu          , Gg          , Xu          , Gg          , Xu          , Gg          , Gg          , Gs          , Gg          , Mm          , Gg          , Gg          , Mm          , Gg^Fet      , Mm^Xm       , Mm          , Hh          , Hh          , Hh          , Mm^Xm       
Gs^Ft       , Gs^Ft       , Gs^Ft       , Gs^Ft       , Gs^Ft       , Gs^Ft       , Gs^Ft       , Gs^Ft       , Gs^Ft       , Xu          , Gg          , Gg          , Gg          , Gs^Ft       , Gg          , Gs^Ft       , Gs          , Gs^Ft       , Gs          , Hh          , Gs          , Hh          , Hh          , Hh          , Hh          , Mm          , Hh          , Hh          , Hh          , Mm^Xm       , Mm          
Gs^Ft       , Gs^Ft       , Gs^Ft       , Hh          , Gg          , Gs^Ft       , Gs^Ft       , Hh          , Gs^Ft       , Xu          , Gg          , Mm          , Gg          , Gg          , Hh          , Mm          , Gg          , Gs^Ft       , Hh          , Gs          , Mm          , Gg          , Hh          , Gs          , Mm          , Hh          , Mm          , Gs^Fp       , Mm          , Gs          , Mm^Xm       
Gs^Fp       , Gs^Ft       , Gg^Fet      , Gs^Fp       , Gs^Fp       , Gg^Fet      , Gs^Ft       , Hh          , Gg^Fet      , Xu          , Gg          , Gg          , Gs^Ft       , Gs^Ft       , Gg          , Hh          , Hh          , Gs          , Gs          , Gg          , Gs          , Gs          , Mm          , Gs          , Mm          , Gs          , Gs          , Mm          , Gg^Fet      , Hh          , Mm          
Gs^Fp       , Gs^Ft       , Hh          , Gs^Ft       , Gs^Fp       , Gs^Ft       , Hh          , Gs^Ft       , Gs^Fp       , Xu          , Mm          , Gg          , Hh          , Gg          , Hh          , Gg          , Xu          , Gg          , Xu          , Gs          , Xu          , Gg          , Xu          , Xu          , Xu          , Xu          , Xu          , Xu          , Xu          , Xu          , Mm          
Gs^Fp       , Gs^Ft       , Gs^Ft       , Gs^Ft       , Gg^Fet      , Gs^Ft       , Gs^Ft       , Gg          , Gs^Fp       , Xu          , Gs^Fp       , Hh          , Gg          , Gg          , Gg          , Mm          , Xu          , Xu          , Gg          , Xu          , Gg          , Xu          , Gg          , Gs^Ft       , Gg          , Gg          , Gg          , Gg          , Gs^Ft       , Hh          , Hh          
Gg^Fet      , Gg          , Gs^Ft       , Gs^Ft       , Gg          , Gs^Fp       , Gg^Fet      , Gs^Fp       , Gs^Ft       , Xu          , Gg          , Gs^Fp       , Gs^Fp       , Gg          , Hh          , Gg          , Xu          , Gg          , Gg          , Mm          , Gg          , Mm          , Gg          , Ggf         , Gs          , Cud         , Gs          , Gs          , Gs          , Gs^Ft       , Hh          
Gs^Fp       , Gs^Ft       , Gs^Ft       , Hh          , Gs^Fp       , Gs^Fp       , Gs^Fp       , Gs^Ft       , Gs^Ft       , Gg          , Gg          , Gg          , Gg          , Gg          , Gg          , Gs^Ft       , Xu          , Chw         , Gg          , Gs          , Hh          , Ggf         , Ggf         , Gg          , Gs          , Gg          , Hh          , Gg          , Hh          , Gg          , Hh          
Gs^Fp       , Hh          , Gg^Fet      , Gs^Fp       , Gs^Ft       , Gs^Ft       , Gs^Ft       , Hh          , Gs^Ft       , Gg^Fet      , Gg          , Gg          , Gs^Ft       , Gs^Ft       , Gg          , Gg          , Xu          , Chw         , Ggf         , Gs          , Gg          , Gg          , Gg          , Hh          , Gg          , Xu          , Ggf         , Gs^Ft       , Gg          , Gs          , Hh          
Gs^Fp       , Gs^Ft       , Gs^Fp       , Gg          , Gs^Fp       , Hh          , Gs^Fp       , Gs^Fp       , Gs^Ft       , Gg          , Gs^Fp       , Gg          , Gs^Fp       , Gs^Ft       , Gs^Ft       , Gg          , Xu          , Gg          , Gg          , Mm          , Gg          , Mm          , Gg          , Gs          , Gs^Ft       , Xu          , Gg          , Gs          , Gg^Wm       , Gs^Ft       , Hh          
Gs^Fp       , Gs^Fp       , Gs^Ft       , Gs^Ft       , Gs^Fp       , Gs^Fp       , Gs^Fp       , Gg^Fet      , Hh          , Xu          , Gs^Fp       , Gg          , Gg          , Gg          , Gs          , Gg          , Xu          , Xu          , Xu          , Xu          , Xu          , Xu          , Xu          , Xu          , Xu          , Xu          , Gs^Ft       , Gs          , Gs          , Gg          , Gs          
Gg^Fet      , Gs^Fp       , Gs^Ft       , Cv          , Gs^Ft       , Cv          , Gs^Ft       , Gg          , Gs^Ft       , Xu          , Gg          , Gs^Ft       , Gg          , Hh          , Gg          , Gs          , Hh          , Xu          , Xu          , Xu          , Xu          , Xu          , Xu          , Xu          , Xu          , Xu          , Gg          , Hh          , Gs          , Hh          , Gs          
Gs^Fp       , Gg          , Cv          , Cv          , Cv          , Cv          , Cv          , Gs^Ft       , Hh          , Xu          , Gg          , Gg          , Gs^Ft       , Gs          , Gg^Wm       , Gg          , Gg          , Gg          , Gs          , Gs          , Gg          , Gg          , Gs          , Gg          , Gg          , Gg          , Gs          , Gs          , Gs^Ft       , Gg          , Gs          
Gs^Ft       , Gs^Fp       , Cv          , Cv          , 7 Kv        , Cv          , Cv          , Gs^Fp       , Gg          , Xu          , Gg          , Hh          , Hh          , Gs          , Gg          , Hh          , Gg          , Ce          , Cv          , Ch          , Cud         , Ch          , Ch          , Cv          , Chr         , Cv          , Gg          , Gg          , Hh          , Gs          , Gs          
Gs^Ft       , Gs^Fp       , Gg^Fet      , Cv          , Cv          , Cv          , Gs^Fp       , Gs^Fp       , Gg^Fet      , Xu          , Gg          , Gs          , Gg          , Gs          , Gg          , Hh          , Gs          , Gg          , Gg          , Gg          , Gg          , Gs          , Gg          , Gg          , Gs          , Gg          , Gs^Ft       , Gs          , Gg          , Gg          , Gs          
Gs^Ft       , Gs^Fp       , Gs^Fp       , Gs^Fp       , Gs^Ft       , Gs^Ft       , Gs^Fp       , Gs^Fp       , Gs^Fp       , Xu          , Re^Uf       , Gs^Ft       , Gs^Ft       , Re^Uf       , Re          , Re          , Re          , Re^Uf       , Re          , Gs^Ft       , Gs^Ft       , Re          , Re          , Re          , Re^Uf       , Gs^Ft       , Gs^Ft       , Re          , Re          , Re^Uf       , Re          
