border_size=1
usage=map

Qxu         , Qxu         , Qxu         , Qxu         , Qxu         , Qxu         , Qxu         , Qxu         , Qxu         , Qxu         , Qxu         , Qxu         , Qxu         , Qxu         , Qxu         , Qxu         , Qxu         , Qxu         , Qxu         , Qxu         , Qxu         , Qxu         , Qxu         , Qxu         , Qxu         , Qxu         , Qxu         , Qxu         , Qxu         , Qxu         , Qxu         , Qxu         , Qxu         , Qxu         , Qxu         
Qxu         , Qxu         , Qxu         , Qxu         , Qxu         , Qxu         , Qxu         , Qxu         , Qxu         , Qxu         , Qxu         , Qxu         , Qxu         , Qxu         , Qxu         , Qxu         , Qxu         , Qxu         , Qxu         , Qxu         , Qxu         , Qxu         , Qxu         , Qxu         , Qxu         , Qxu         , Qxu         , Qxu         , Qxu         , Qxu         , Qxu         , Qxu         , Qxu         , Qxu         , Qxu         
Qxu         , Qxu         , Xu          , Xu          , Xu          , Xu          , Xu          , Xu          , Xu          , Xu          , Xu          , Xu          , Xu          , Xu          , Xu          , Xu          , Xu          , Xu          , Xu          , Xu          , Xu          , Xu          , Xu          , Xu          , Xu          , Xu          , Xu          , Xu          , Xu          , Xu          , Xu          , Xu          , Xu          , Qxu         , Qxu         
Qxu         , Qxu         , Xu          , Ql          , Wwf         , Wwf         , Wwf         , Wwf         , Hh          , Mm          , Hh          , Ds          , Ds          , Gg          , Hh          , Mm          , Mm          , Xu          , Mm          , Mm          , Hh          , Gg          , Ds          , Ds          , Hh          , Mm          , Hh          , Wwf         , Wwf         , Wwf         , Wwf         , Ql          , Xu          , Qxu         , Qxu         
Qxu         , Qxu         , Xu          , Wwf         , Wwf         , Wwf         , Wwf         , Wwf         , Xu          , Gs^Fp       , Gg          , Ds          , Gs^Fp       , Gg          , Ww          , Gg^Fet      , Hh          , Xu          , Hh          , Gg^Fet      , Ww          , Gg          , Gs^Fp       , Ds          , Gg          , Gs^Fp       , Xu          , Wwf         , Wwf         , Wwf         , Wwf         , Wwf         , Xu          , Qxu         , Qxu         
Qxu         , Qxu         , Xu          , Gs^Fp       , Wwf         , 1 Kh        , Wwf         , Wwf         , Xu          , Gg          , Gg          , Gg          , Hh          , Ww          , Ww          , Ss          , Ss          , Xu          , Ss          , Ss          , Ww          , Ww          , Hh          , Gg          , Gg          , Gg          , Xu          , Wwf         , Wwf         , 3 Kh        , Wwf         , Gs^Fp       , Xu          , Qxu         , Qxu         
Qxu         , Qxu         , Xu          , Hh          , Chr         , Wwf         , Wwf         , Wwf         , Wwf         , Xu          , Wwf         , Gg          , Gs^Fp       , Chw         , Ww          , Ss          , Chs         , Xu          , Chs         , Ss          , Ww          , Chw         , Gs^Fp       , Gg          , Wwf         , Xu          , Wwf         , Wwf         , Wwf         , Wwf         , Chr         , Hh          , Xu          , Qxu         , Qxu         
Qxu         , Qxu         , Xu          , Mm          , Hh          , Gg          , Gg          , Wwf         , Wwf         , Wwf         , Mm          , Wwf         , Wwf         , Wwf         , Ww          , Ss          , Ss          , Xu          , Ss          , Ss          , Ww          , Wwf         , Wwf         , Wwf         , Mm          , Wwf         , Wwf         , Wwf         , Gg          , Gg          , Hh          , Mm          , Xu          , Qxu         , Qxu         
Qxu         , Qxu         , Xu          , Xu          , Xu          , Gs^Fp       , Gg          , Gg          , Hh          , Chw         , Chr         , Mm^Xm       , Gg          , Gg          , Gg          , Ss          , Gs^Fp       , Xu          , Gs^Fp       , Ss          , Gg          , Gg          , Gg          , Mm^Xm       , Chr         , Chw         , Hh          , Gg          , Gg          , Gs^Fp       , Xu          , Xu          , Xu          , Qxu         , Qxu         
Qxu         , Qxu         , Xu          , Uu          , Uu          , Cud         , Aa^Fpa      , Gg          , Gg          , Gs^Fp       , Chw         , Mm          , Ds          , Gg          , Gg          , Hh          , Mm          , Xu          , Mm          , Hh          , Gg          , Gg          , Ds          , Mm          , Chw         , Gs^Fp       , Gg          , Gg          , Aa^Fpa      , Cud         , Uu          , Uu          , Xu          , Qxu         , Qxu         
Qxu         , Qxu         , Xu          , Uu^Ii       , Uu          , Xu          , Ha          , Aa          , Aa^Fpa      , Hh          , Wwf         , Wwf         , Wwf         , Ds          , Gg          , Ha          , Aa^Fpa      , Xu          , Aa^Fpa      , Ha          , Gg          , Ds          , Wwf         , Wwf         , Wwf         , Hh          , Aa^Fpa      , Aa          , Ha          , Xu          , Uu          , Uu^Ii       , Xu          , Qxu         , Qxu         
Qxu         , Qxu         , Xu          , Xu          , Xu          , Xu          , Mm          , Chr         , Aa          , Ds          , Ds          , Wwf         , Mm          , Mm^Xm       , Gg          , Aa          , Aa          , Xu          , Aa          , Aa          , Gg          , Mm^Xm       , Mm          , Wwf         , Ds          , Ds          , Aa          , Chr         , Mm          , Xu          , Xu          , Xu          , Xu          , Qxu         , Qxu         
Qxu         , Qxu         , Xu          , Xu          , Xu          , Xu          , Xu          , Ha          , Aa^Fpa      , Gg          , Gg          , Mm^Xm       , Gs^Fp       , Hh          , Gg          , Aa          , Aa^Fpa      , Xu          , Aa^Fpa      , Aa          , Gg          , Hh          , Gs^Fp       , Mm^Xm       , Gg          , Gg          , Aa^Fpa      , Ha          , Xu          , Xu          , Xu          , Xu          , Xu          , Qxu         , Qxu         
Qxu         , Qxu         , Xu          , Xu          , Xu          , Xu          , Xu          , Xu          , Xu          , Gg          , Gg          , Gg          , Gg          , Gg          , Hh          , Aa          , Cud         , Xu          , Cud         , Aa          , Hh          , Gg          , Gg          , Gg          , Gg          , Gg          , Xu          , Xu          , Xu          , Xu          , Xu          , Xu          , Xu          , Qxu         , Qxu         
Qxu         , Qxu         , Xu          , Xu          , Xu          , Xu          , Xu          , Xu          , Rd          , Cud         , Xu          , Gg          , Mm          , Gg          , Cud         , Cud         , Cud         , Xu          , Cud         , Cud         , Cud         , Gg          , Mm          , Gg          , Xu          , Cud         , Rd          , Xu          , Xu          , Xu          , Xu          , Xu          , Xu          , Qxu         , Qxu         
Qxu         , Qxu         , Xu          , Xu          , Xu          , Xu          , Rd          , Rd          , Rd          , Xu          , Xu          , Xu          , Xu          , Cud         , Cud         , 6 Kud       , Cud         , Xu          , Cud         , 8 Kud       , Cud         , Cud         , Xu          , Xu          , Xu          , Xu          , Rd          , Rd          , Rd          , Xu          , Xu          , Xu          , Xu          , Qxu         , Qxu         
Qxu         , Qxu         , Xu          , Xu          , Xu          , Xu          , Xu          , Rd          , Xu          , Xu          , Xu          , Xu          , Xu          , Xu          , Xu          , Cud         , Xu          , Xu          , Xu          , Cud         , Xu          , Xu          , Xu          , Xu          , Xu          , Xu          , Xu          , Rd          , Xu          , Xu          , Xu          , Xu          , Xu          , Qxu         , Qxu         
Qxu         , Qxu         , Xu          , Xu          , Xu          , Xu          , Xu          , Xu          , Xu          , Xu          , Xu          , Xu          , Xu          , Xu          , Xu          , Xu          , Xu          , 5 Kh        , Xu          , Xu          , Xu          , Xu          , Xu          , Xu          , Xu          , Xu          , Xu          , Xu          , Xu          , Xu          , Xu          , Xu          , Xu          , Qxu         , Qxu         
Qxu         , Qxu         , Xu          , Xu          , Xu          , Xu          , Rd          , Rd          , Rd          , Xu          , Xu          , Xu          , Xu          , Xu          , Cud         , Cud         , Cud         , Xu          , Cud         , Cud         , Cud         , Xu          , Xu          , Xu          , Xu          , Xu          , Rd          , Rd          , Rd          , Xu          , Xu          , Xu          , Xu          , Qxu         , Qxu         
Qxu         , Qxu         , Xu          , Xu          , Xu          , Xu          , Xu          , Rd          , Rd          , Xu          , Xu          , Xu          , Mm          , Cud         , Cud         , 9 Kud       , Cud         , Xu          , Cud         , 7 Kud       , Cud         , Cud         , Mm          , Xu          , Xu          , Xu          , Rd          , Rd          , Xu          , Xu          , Xu          , Xu          , Xu          , Qxu         , Qxu         
Qxu         , Qxu         , Xu          , Xu          , Xu          , Xu          , Xu          , Xu          , Xu          , Cud         , Gg          , Gg          , Gg          , Gg          , Hh          , Cud         , Cud         , Xu          , Cud         , Cud         , Hh          , Gg          , Gg          , Gg          , Gg          , Cud         , Xu          , Xu          , Xu          , Xu          , Xu          , Xu          , Xu          , Qxu         , Qxu         
Qxu         , Qxu         , Xu          , Xu          , Xu          , Xu          , Xu          , Xu          , Aa^Fpa      , Gg          , Gg          , Gg          , Gs^Fp       , Gg          , Gg          , Aa          , Aa^Fpa      , Xu          , Aa^Fpa      , Aa          , Gg          , Gg          , Gs^Fp       , Gg          , Gg          , Gg          , Aa^Fpa      , Xu          , Xu          , Xu          , Xu          , Xu          , Xu          , Qxu         , Qxu         
Qxu         , Qxu         , Xu          , Xu          , Xu          , Xu          , Mm          , Ha          , Aa          , Gg          , Ds          , Mm^Xm       , Mm          , Hh          , Gg          , Aa          , Aa          , Xu          , Aa          , Aa          , Gg          , Hh          , Mm          , Mm^Xm       , Ds          , Gg          , Aa          , Ha          , Mm          , Xu          , Xu          , Xu          , Xu          , Qxu         , Qxu         
Qxu         , Qxu         , Xu          , Xu          , Uu          , Xu          , Ha          , Chr         , Aa^Fpa      , Ds          , Wwf         , Wwf         , Wwf         , Mm^Xm       , Gg          , Aa          , Aa^Fpa      , Xu          , Aa^Fpa      , Aa          , Gg          , Mm^Xm       , Wwf         , Wwf         , Wwf         , Ds          , Aa^Fpa      , Chr         , Ha          , Xu          , Uu          , Xu          , Xu          , Qxu         , Qxu         
Qxu         , Qxu         , Xu          , Uu^Ii       , Uu          , Xu          , Aa^Fpa      , Aa          , Gg          , Hh          , Chw         , Wwf         , Ds          , Ds          , Gg          , Ha          , Mm          , Xu          , Mm          , Ha          , Gg          , Ds          , Ds          , Wwf         , Chw         , Hh          , Gg          , Aa          , Aa^Fpa      , Xu          , Uu          , Uu^Ii       , Xu          , Qxu         , Qxu         
Qxu         , Qxu         , Xu          , Uu          , Xu          , Cud         , Gg          , Gg          , Hh          , Gs^Fp       , Chr         , Mm          , Gg          , Gg          , Gg          , Hh          , Gs^Fp       , Xu          , Gs^Fp       , Hh          , Gg          , Gg          , Gg          , Mm          , Chr         , Gs^Fp       , Hh          , Gg          , Gg          , Cud         , Xu          , Uu          , Xu          , Qxu         , Qxu         
Qxu         , Qxu         , Xu          , Xu          , Hh          , Gs^Fp       , Gg          , Gg          , Wwf         , Chw         , Mm          , Mm^Xm       , Wwf         , Gg          , Ww          , Ss          , Ss          , Xu          , Ss          , Ss          , Ww          , Gg          , Wwf         , Mm^Xm       , Mm          , Chw         , Wwf         , Gg          , Gg          , Gs^Fp       , Hh          , Xu          , Xu          , Qxu         , Qxu         
Qxu         , Qxu         , Xu          , Mm          , Chr         , Gg          , Wwf         , Wwf         , Wwf         , Wwf         , Wwf         , Wwf         , Gs^Fp       , Wwf         , Ww          , Ss          , Chs         , Xu          , Chs         , Ss          , Ww          , Wwf         , Gs^Fp       , Wwf         , Wwf         , Wwf         , Wwf         , Wwf         , Wwf         , Gg          , Chr         , Mm          , Xu          , Qxu         , Qxu         
Qxu         , Qxu         , Xu          , Hh          , Wwf         , Wwf         , Wwf         , Wwf         , Xu          , Xu          , Gg          , Gg          , Hh          , Chw         , Ww          , Ss          , Ss          , Xu          , Ss          , Ss          , Ww          , Chw         , Hh          , Gg          , Gg          , Xu          , Xu          , Wwf         , Wwf         , Wwf         , Wwf         , Hh          , Xu          , Qxu         , Qxu         
Qxu         , Qxu         , Xu          , Gs^Fp       , Wwf         , 4 Kh        , Wwf         , Wwf         , Xu          , Gg          , Gg          , Gg          , Gs^Fp       , Ww          , Ww          , Ss          , Hh          , Xu          , Hh          , Ss          , Ww          , Ww          , Gs^Fp       , Gg          , Gg          , Gg          , Xu          , Wwf         , Wwf         , 2 Kh        , Wwf         , Gs^Fp       , Xu          , Qxu         , Qxu         
Qxu         , Qxu         , Xu          , Wwf         , Wwf         , Wwf         , Wwf         , Wwf         , Hh          , Gs^Fp       , Hh          , Ds          , Ds          , Gg          , Hh          , Gg^Fet      , Mm          , Xu          , Mm          , Gg^Fet      , Hh          , Gg          , Ds          , Ds          , Hh          , Gs^Fp       , Hh          , Wwf         , Wwf         , Wwf         , Wwf         , Wwf         , Xu          , Qxu         , Qxu         
Qxu         , Qxu         , Xu          , Ql          , Xu          , Wwf         , Xu          , Wwf         , Xu          , Mm          , Xu          , Ds          , Xu          , Gg          , Xu          , Mm          , Xu          , Xu          , Xu          , Mm          , Xu          , Gg          , Xu          , Ds          , Xu          , Mm          , Xu          , Wwf         , Xu          , Wwf         , Xu          , Ql          , Xu          , Qxu         , Qxu         
Qxu         , Qxu         , Qxu         , Xu          , Qxu         , Xu          , Qxu         , Xu          , Qxu         , Xu          , Qxu         , Xu          , Qxu         , Xu          , Qxu         , Xu          , Qxu         , Xu          , Qxu         , Xu          , Qxu         , Xu          , Qxu         , Xu          , Qxu         , Xu          , Qxu         , Xu          , Qxu         , Xu          , Qxu         , Xu          , Qxu         , Qxu         , Qxu         
Qxu         , Qxu         , Qxu         , Qxu         , Qxu         , Qxu         , Qxu         , Qxu         , Qxu         , Qxu         , Qxu         , Qxu         , Qxu         , Qxu         , Qxu         , Qxu         , Qxu         , Qxu         , Qxu         , Qxu         , Qxu         , Qxu         , Qxu         , Qxu         , Qxu         , Qxu         , Qxu         , Qxu         , Qxu         , Qxu         , Qxu         , Qxu         , Qxu         , Qxu         , Qxu         
Qxu         , Qxu         , Qxu         , Qxu         , Qxu         , Qxu         , Qxu         , Qxu         , Qxu         , Qxu         , Qxu         , Qxu         , Qxu         , Qxu         , Qxu         , Qxu         , Qxu         , Qxu         , Qxu         , Qxu         , Qxu         , Qxu         , Qxu         , Qxu         , Qxu         , Qxu         , Qxu         , Qxu         , Qxu         , Qxu         , Qxu         , Qxu         , Qxu         , Qxu         , Qxu         
