border_size=1
usage=map

Xu          , Xu          , Xu          , Xu          , Xu          , Xu          , Xu          , Xu          , Xu          , Xu          , Xu          , Xu          , Xu          , Xu          , Xu          , Xu          , Xu          , Xu          , Xu          , Xu          , Xu          , Xu          , Xu          , Xu          , Xu          , Xu          , Xu          , Xu          , Xu          , Xu          , Xu          , Xu          , Xu          , Xu          , Xu          , Xu          , Xu          , Xu          , Xu          , Xu          , Xu          , Xu          
Xu          , 1 Kh        , Rr          , 5 Kh        , Gg          , Gs^Ft       , Hh          , Gs^Ft       , Gg          , Xu          , Xu          , Xu          , Gg          , Gg          , Kud         , Ggf         , Gs          , Gg          , Kud         , Ggf         , Gs          , Gg          , Kud         , Ggf         , Gs          , Gg          , Kud         , Ggf         , Gs          , Gg          , Kud         , Ggf         , Gs          , Gg          , Kud         , Xu          , Xu          , Xu          , Ggf         , Aa          , Gg          , Xu          
Xu          , 2 Kh        , 3 Kh        , 4 Kh        , Gg          , Gg          , Gg          , Gs^Ft       , Gg          , Hh          , Mm          , Xu          , Xu          , Ggf         , Xu          , Gg          , Xu          , Ggf         , Xu          , Gg          , Xu          , Ggf         , Xu          , Gg          , Xu          , Ggf         , Xu          , Gg          , Xu          , Ggf         , Xu          , Gg          , Xu          , Ggf         , Xu          , Xu          , Xu          , Xu          , Ss          , Gg          , Ggf         , Xu          
Xu          , Gg          , Gg          , Gg          , Ggf         , Gg^Wm       , Gg          , Ggf         , Gg          , Gs^Fp       , Gs          , Gg          , Hh          , Xu          , Xu          , Xu          , Hh          , Xu          , Hh          , Xu          , Hh          , Xu          , Gs^Fp       , Xu          , Gs^Fp       , Xu          , Gs^Fp       , Xu          , Gs          , Xu          , Gs          , Xu          , Gs          , Xu          , Xu          , Xu          , Xu          , Xu          , Gs          , Gg          , Gg          , Xu          
Xu          , Gs^Ft       , Ggf         , Gg          , Gg          , Ggf         , Gg          , Gg          , Gg          , Gs          , Ss          , Gs^Fp       , Gs^Fp       , Ss          , Wwf         , Xu          , Xu          , Xu          , Xu          , Xu          , Xu          , Xu          , Xu          , Xu          , Xu          , Xu          , Xu          , Xu          , Xu          , Xu          , Xu          , Xu          , Xu          , Xu          , Ss          , Xu          , Xu          , Xu          , Gg          , Chw         , Gg          , Xu          
Xu          , Gs^Ft       , Gs^Ft       , Gs^Ft       , Hh          , Gg          , Gg          , Hh          , Gs^Fp       , Gg          , Gs          , Gs          , Gg          , Gs          , Gg          , Wwf         , Wwf         , Re          , Hh          , Gs          , Mm          , Hh          , Re          , Wwf         , Ss          , Ww          , Ww          , Ww          , Gs          , Chw         , Wwf         , Wwf         , Ww          , Xu          , Xu          , Ss          , Ss          , Xu          , Ss          , Gs          , Gs^Ft       , Xu          
Xu          , Xu          , Xu          , Hh          , Hh          , Gs^Fp       , Gg          , Gg          , Hh          , Gs          , Gg          , Gs^Fp       , Gg          , Hh          , Gs          , Ss          , Ss          , Wwf         , Gs          , Gs          , Gs^Fp       , Ss          , Wwf         , Wwf         , Gs          , Ss          , Ss          , Hh          , Gs          , Wwf         , Ss          , Ss          , Ss          , Ss          , Ww          , Xu          , Xu          , Xu          , Gs          , Gs          , Gg          , Xu          
Xu          , Xu          , Gg          , Xu          , Xu          , Mm          , Gs^Fp       , Gg          , Gg          , Hh          , Gg          , Gg          , Ss          , Gg          , Gs          , Gs^Fp       , Re          , Wwf         , Gs          , Ss          , Wwf         , Wwf         , Ss          , Gs          , Gs^Fp       , Ss          , Ss          , Gs          , Re          , Wwf         , Wwf         , Wwf         , Wwf         , Ss          , Ss          , Re          , Hh          , Xu          , Xu          , Chw         , Gg          , Xu          
Xu          , Cud         , Xu          , Cud         , Gg          , Xu          , Xu          , Gs^Fp       , Hh          , Gg          , Gg          , Gg          , Gg          , Gg          , Gg          , Gs          , Ss          , Wwf         , Wwf         , Ss          , Wwf         , Re          , Hh          , Mm          , Re          , Wwf         , Wwf         , Re          , Gs^Fp       , Ss          , Re          , Hh          , Hh          , Wwf         , Wwf         , Gs          , Gs          , Mm          , Hh          , Xu          , Xu          , Xu          
Xu          , Gs          , Xu          , Gg          , Mm^Xm       , Gs          , Gs          , Xu          , Xu          , Gg          , Gs^Ft       , Gg          , Gg          , Gg          , Mm          , Gg          , Re          , Ss          , Gs^Fp       , Wwf         , Xu          , Xu          , Xu          , Xu          , Xu          , Xu          , Xu          , Wwf         , Wwf         , Ss          , Re          , Hh          , Re          , Re          , Gs          , Ss          , Ss          , Re          , Re          , Gs          , Ss          , Xu          
Xu          , Uu          , Xu          , Ggf         , Md^Xm       , Md^Xm       , Mm^Xm       , Gg          , Xu          , Gs^Ft       , Gs^Ft       , Hh          , Gg          , Gg          , Gs^Fp       , Gs^Ft       , Gg          , Re          , Re          , Ss          , Xu          , Rr          , Rr          , Xu          , Xu          , Rp          , Xu          , Xu          , Xu          , Wwf         , Mm          , Re          , Gs^Fp       , Ss          , Gs          , Gs          , Re          , Ss          , Ss          , Re          , Gs^Fp       , Xu          
Xu          , Ww          , Xu          , Gg          , Mm^Xm       , Md^Xm       , Gs          , Gg          , Xu          , Gg          , Gg          , Gg          , Gg          , Gg          , Gg          , Gg          , Hh          , Gg          , Gs^Ft       , Re          , Gs^Ft       , Xu          , Xu          , Rr          , Rr          , Xu          , Xu          , Xu          , Xu          , Xu          , Xu          , Gs^Fp       , Gs^Fp       , Ss          , Wwf         , Wwf         , Wwf         , Gs          , Ss          , Re          , Re          , Xu          
Xu          , Ds          , Xu          , Gs          , Gg          , Gg          , Gg          , Cud         , Cud         , Gg          , Gg          , Hh          , Gg          , Gg          , Gg          , Hh          , Gs          , Gg          , Gg          , Gs          , Gs          , Gs          , Hh          , Xu          , Xu          , Rr          , Rr          , Xu          , Xu          , Xu          , Xu          , Xu          , Xu          , Ss          , Ww          , Ss          , Wwf         , Gs          , Gs          , Gs^Fp       , Re          , Xu          
Xu          , Gg          , Xu          , Gs          , Cud         , Gg          , Xu          , Xu          , Gg          , Gg          , Gg          , Gg          , Gg          , Ggf         , Gg          , Gs^Fp       , Gs          , Gs^Fp       , Gs^Fp       , Gg          , Gg^Fet      , Gs          , Gs          , Gs          , Gg          , Xu          , Xu          , Rr          , Rr          , Xu          , Xu          , Xu          , Xu          , Xu          , Xu          , Ss          , Ss          , Wwf         , Gs^Fp       , Hh          , Ss          , Xu          
Xu          , Cud         , Xu          , Gg          , Gg          , Ggf         , Xu          , Ss          , Hh          , Gg          , Gg          , Mm          , Hh          , Gg          , Gg          , Gg          , Xu          , Gs          , Gs          , Gg          , Gg          , Gg          , Gs^Fp       , Gs          , Gg          , Hh          , Gg          , Xu          , Xu          , Rr          , Rr          , Xu          , Xu          , Xu          , Xu          , Ss          , Wwf         , Wwf         , Re          , Re          , Chw         , Xu          
Xu          , Gg          , Xu          , Gg          , Md^Xm       , Gs          , Xu          , Ss          , Hh          , Gs^Fp       , Gs          , Gg          , Gs^Fp       , Gg          , Gg          , Xu          , Hh          , Xu          , Xu          , Gg          , Hh          , Gg          , Gs          , Gs          , Gs^Ft       , Gg          , Gs^Ft       , Gg          , Mm          , Xu          , Xu          , Rr          , Rr          , Xu          , Xu          , Wwf         , Gs          , Hh          , Chw         , Re          , Chw         , Xu          
Xu          , Uu          , Xu          , Gg          , Gg          , Gg          , Xu          , Gs^Fp       , Gg          , Gs          , Gs          , Gs          , Hh          , Gs^Fp       , Xu          , Xu          , Hh          , Mm          , Xu          , Mm          , Hh          , Gs          , Gs^Fp       , Gs          , Gg          , Gg          , Hh          , Gg          , Gg          , Gs^Fp       , Gg          , Xu          , Xu          , Rr          , Xu          , Ss          , Chw         , Gs          , Chw         , Chw         , Chw         , Xu          
Xu          , Ww          , Xu          , Gg          , Cud         , Gg          , Xu          , Gs^Fp       , Gg          , Gs          , Gs          , Gs          , Gs^Fp       , Gs^Fp       , Xu          , Mm          , Mm          , Hh          , Mm          , Xu          , Xu          , Gs          , Gs          , Hh          , Gs          , Gs^Fp       , Gs^Fp       , Gg          , Gg          , Hh          , Hh          , Hh          , Mm          , Xu          , Xu          , Re          , Xu          , Chw         , Chw         , Chw         , 6 Khw       , Xu          
Xu          , Ds          , Xu          , Gg          , Gg          , Gs          , Xu          , Gg          , Gg          , Hh          , Gs^Fp       , Gs          , Gs^Fp       , Xu          , Hh          , Hh          , Hh          , Hh          , Mm          , Hh          , Mm^Xm       , Xu          , Gg          , Gs          , Gs^Fp       , Gs^Fp       , Gs          , Gg          , Gg          , Gg          , Gg          , Gg          , Gg          , Hh          , Gs^Fp       , Xu          , Hh          , Xu          , Xu          , Xu          , Xu          , Xu          
Xu          , Gs          , Xu          , Ggf         , Mm^Xm       , Gg          , Xu          , Gg          , Gg          , Ss          , Gg          , Gs          , Gs          , Xu          , Mm^Xm       , Mm          , Hh          , Mm          , Hh          , Hh          , Mm          , Xu          , Gg^Fet      , Gs^Fp       , Gs          , Gs          , Gs^Ft       , Gs^Ft       , Gs^Fp       , Ggf         , Gg          , Gs^Fp       , Gs          , Gs          , Gs          , Gg          , Gg          , Hh          , Gs          , Gs^Fp       , Gs^Fp       , Xu          
Xu          , Cud         , Xu          , Gg          , Gs          , Gs          , Xu          , Hh          , Gg          , Gg          , Gs^Fp       , Hh          , Gg          , Xu          , Xu          , Mm          , Mm          , Hh          , Mm          , Hh          , Mm          , Xu          , Gg          , Gs^Fp       , Gs^Fp       , Hh          , Gs^Ft       , Gg^Fet      , Gs^Fp       , Gg          , Hh          , Hh          , Gg          , Cud         , Gg          , Gg          , Gg          , Ggf         , Gg          , Gg          , Gg          , Xu          
Xu          , Gs          , Xu          , Gg          , Cud         , Gg          , Xu          , Gs^Fp       , Hh          , Gg          , Gs          , Gg          , Ch          , Xu          , Rp          , Xu          , Xu          , Hh          , Mm          , Hh          , Xu          , Xu          , Gs^Fp       , Gs          , Gs          , Gs^Ft       , Gs^Fp       , Gs^Fp       , Xu          , Xu          , Xu          , Hh          , Gs          , Gs          , Mm          , Hh          , Gg          , Gg          , Gg          , Hh          , Gs^Fp       , Xu          
Xu          , Uu          , Xu          , Gs          , Gg          , Gg          , Xu          , Mm          , Hh          , Gg          , Gs          , Gs          , Gs          , Xu          , Xu          , Xu          , Mm          , Xu          , Xu          , Xu          , Gs^Ft       , Gg          , Mm          , Gg^Fet      , Hh          , Gs^Fp       , Gs^Ft       , Hh          , Xu          , Gs^Fp       , Gs^Fp       , Xu          , Xu          , Gs          , Hh          , Gs^Fp       , Gg          , Gs^Fp       , Hh          , Gs          , Gs          , Xu          
Xu          , Ww          , Xu          , Gg          , Md^Xm       , Gg          , Xu          , Gs          , Gs^Fp       , Gg          , Gs^Fp       , Gs^Fp       , Gg          , Xu          , Hh          , Mm          , Hh          , Mm          , Mm^Xm       , Xu          , Gs^Ft       , Hh          , Gs          , Gs^Fp       , Gs          , Gg          , Gg^Fet      , Gs^Ft       , Xu          , Gs^Fp       , Gs^Fp       , Gs^Ft       , Gg^Fet      , Xu          , Xu          , Gg          , Gg          , Gs          , Gs^Fp       , Gs^Fp       , Gs^Fp       , Xu          
Xu          , Ds          , Xu          , Gg          , Gg          , Ggf         , Xu          , Gs          , Gg          , Gg          , Gg          , Gg          , Hh          , Xu          , Hh          , Hh          , Hh          , Mm          , Xu          , Xu          , Gs^Ft       , Hh          , Gs          , Gs^Fp       , Gs          , Gs^Ft       , Gg          , Gs^Ft       , Xu          , Gg^Fet      , Gs^Fp       , Gs^Fp       , Gs^Ft       , Gs^Fp       , Xu          , Gg          , Gs^Fp       , Gs          , Hh          , Gs          , Mm          , Xu          
Xu          , Gg          , Xu          , Gg          , Cud         , Gg          , Xu          , Gs^Fp       , Ggf         , Gg          , Hh          , Hh          , Mm          , Xu          , Mm          , Mm          , Mm^Xm       , Hh          , Xu          , Gg          , Gg          , Gs^Ft       , Gs^Fp       , Gs^Fp       , Gs^Ft       , Gg          , Ce          , Xu          , Rp          , Xu          , Gs^Fp       , Gg^Fet      , Gs^Ft       , Gs^Fp       , Xu          , Gg          , Ggf         , Gg          , Gg          , Gg          , Hh          , Xu          
Xu          , Cud         , Xu          , Xu          , Xu          , Xu          , Gg          , Gg          , Gg          , Gg          , Hh          , Mm          , Mm^Xm       , Xu          , Hh          , Hh          , Mm          , Xu          , Gs^Fp       , Gg          , Gg^Fet      , Gs^Ft       , Gs^Ft       , Gg          , Hh          , Gg          , Gg          , Xu          , Xu          , Xu          , Xu          , Gs^Ft       , Gg^Fet      , Gs^Ft       , Xu          , Gg          , Hh          , Gg          , Gg          , Hh          , Hh          , Xu          
Xu          , Xu          , Xu          , Xu          , Xu          , Ss          , Hh          , Gg          , Gs          , Gg          , Gg          , Mm          , Mm          , Xu          , Mm          , Hh          , Xu          , Xu          , Gs^Fp       , Gs          , Gs^Fp       , Gs^Fp       , Gs          , Gg          , Gs^Ft       , Mm          , Xu          , Xu          , Gs^Fp       , Gs^Fp       , Gs^Fp       , Xu          , Xu          , Gs^Fp       , Xu          , Mm          , Gs^Fp       , Hh          , Gg          , Gs^Fp       , Gs          , Xu          
Xu          , Xu          , Xu          , Xu          , Xu          , Gg          , Gg          , Gg          , Gs^Fp       , Gs          , Gs^Fp       , Gs^Fp       , Hh          , Xu          , Hh          , Hh          , Xu          , Gg^Fet      , Gs          , Hh          , Gs^Fp       , Hh          , Gs          , Gs^Ft       , Gs^Ft       , Ggf         , Xu          , Gg^Fet      , Gs^Ft       , Gs^Fp       , Gs^Ft       , Gs^Ft       , Gs^Ft       , Xu          , Xu          , Gs          , Gs^Fp       , Gg          , Gg          , Gs^Fp       , Gs          , Xu          
Xu          , Xu          , Ch          , Xu          , Gg          , Gg          , Hh          , Gs^Fp       , Gs^Fp       , Gs          , Gs          , Gs          , Gs^Fp       , Xu          , Xu          , Xu          , Gg          , Hh          , Gg          , Gs          , Gs^Ft       , Gs^Fp       , Gs          , Gs^Ft       , Gg          , Gs^Ft       , Xu          , Gs^Ft       , Gs^Fp       , Gs^Ft       , Gs^Ft       , Gs^Ft       , Gs^Ft       , Gs^Ft       , Xu          , Gs          , Gs          , Gg          , Ggf         , Gs^Fp       , Cud         , Xu          
Xu          , Ch          , Ch          , Ch          , Ch          , Gg          , Gg          , Gs          , Gs          , Gs^Fp       , Gs          , Gs          , Ss          , Xu          , Ce          , Ce          , Ce          , Ce          , Ce          , Gg          , Gs^Ft       , Gg          , Gg^Fet      , Hh          , Gg          , Xu          , Xu          , Gs^Fp       , Gs^Ft       , Gs^Ft       , Gs^Fp       , Gs^Fp       , Gs^Fp       , Gg^Fet      , Xu          , Hh          , Gg          , Hh          , Cud         , Cud         , Cud         , Xu          
Xu          , Ch          , Ch          , Ch          , Ch          , Hh          , Gg          , Gg          , Hh          , Gs          , Gs^Fp       , Hh          , Gg          , Xu          , Ce          , Ce          , Ce          , Ce          , Ce          , Gg          , Gg          , Gg          , Hh          , Gg          , Xu          , Xu          , Xu          , Xu          , Xu          , Gs^Ft       , Gs^Ft       , Gs^Fp       , Gs^Fp       , Gs^Fp       , Xu          , Gg          , Cud         , Cud         , Cud         , Cud         , Cud         , Xu          
Xu          , 7 Kh        , Ch          , Ch          , Ch          , Gg          , Gs^Fp       , Hh          , Mm          , Hh          , Gg          , Gg          , Gg          , Xu          , 8 Ke        , Ce          , Ce          , Ce          , Gg          , Gs^Fp       , Gg^Fet      , Mm          , Xu          , Xu          , Xu          , Xu          , Xu          , Xu          , Xu          , Xu          , Xu          , Gg^Fet      , Gs^Fp       , Gs^Fp       , Xu          , Cud         , Cud         , Cud         , Cud         , Cud         , 9 Kud       , Xu          
Xu          , Xu          , Xu          , Xu          , Xu          , Xu          , Xu          , Xu          , Xu          , Xu          , Xu          , Xu          , Xu          , Xu          , Xu          , Xu          , Xu          , Xu          , Xu          , Xu          , Xu          , Xu          , Xu          , Xu          , Xu          , Xu          , Xu          , Xu          , Xu          , Xu          , Xu          , Xu          , Xu          , Xu          , Xu          , Xu          , Xu          , Xu          , Xu          , Xu          , Xu          , Xu          
